ID	annot_type	fine_annot_type
AAACAAGTATCTCCCA-1	Surrounding tumor	Tumor_edge_5
AAACACCAATAACTGC-1	Invasive	IDC_4
AAACAGAGCGACTCCT-1	Healthy	Healthy_1
AAACAGGGTCTATATT-1	Invasive	IDC_3
AAACAGTGTTCCTGGG-1	Invasive	IDC_4
AAACATTTCCCGGATT-1	Invasive	IDC_2
AAACCCGAACGAAATC-1	Surrounding tumor	Tumor_edge_3
AAACCGGGTAGGTACC-1	Tumor	DCIS/LCIS_3
AAACCTAAGCAGCCGG-1	Invasive	IDC_2
AAACCTCATGAAGTTG-1	Surrounding tumor	Tumor_edge_2
AAACGAAGAACATACC-1	Tumor	DCIS/LCIS_5
AAACGAGACGGTTGAT-1	Invasive	IDC_6
AAACGCCCGAGATCGG-1	Healthy	Healthy_1
AAACGGGCGTACGGGT-1	Invasive	IDC_2
AAACGGTTGCGAACTG-1	Surrounding tumor	Tumor_edge_6
AAACGTGTTCGCCCTA-1	Healthy	Healthy_1
AAACTAACGTGGCGAC-1	Healthy	Healthy_1
AAACTCGGTTCGCAAT-1	Invasive	IDC_2
AAACTCGTGATATAAG-1	Healthy	Healthy_1
AAACTGCTGGCTCCAA-1	Healthy	Healthy_2
AAACTTAATTGCACGC-1	Invasive	IDC_4
AAACTTGCAAACGTAT-1	Surrounding tumor	Tumor_edge_2
AAAGAATGTGGACTAA-1	Invasive	IDC_2
AAAGACCCAAGTCGCG-1	Invasive	IDC_5
AAAGACTGGGCGCTTT-1	Surrounding tumor	Tumor_edge_2
AAAGCTTGCCTACATA-1	Healthy	Healthy_1
AAAGGCCCTATAATAC-1	Invasive	IDC_4
AAAGGCTACGGACCAT-1	Tumor	DCIS/LCIS_4
AAAGGCTCTCGCGCCG-1	Healthy	Healthy_2
AAAGGGATGTAGCAAG-1	Invasive	IDC_7
AAAGGGCAGCTTGAAT-1	Surrounding tumor	Tumor_edge_2
AAAGGTAAGCTGTACC-1	Healthy	Healthy_1
AAAGTAGCATTGCTCA-1	Surrounding tumor	Tumor_edge_2
AAAGTCACTGATGTAA-1	Invasive	IDC_5
AAAGTCGACCCTCAGT-1	Surrounding tumor	Tumor_edge_2
AAAGTGTGATTTATCT-1	Surrounding tumor	Tumor_edge_3
AAAGTTGACTCCCGTA-1	Surrounding tumor	Tumor_edge_3
AAATAACCATACGGGA-1	Surrounding tumor	Tumor_edge_1
AAATAAGGTAGTGCCC-1	Surrounding tumor	Tumor_edge_3
AAATACCTATAAGCAT-1	Healthy	Healthy_2
AAATAGCTTAGACTTT-1	Tumor	DCIS/LCIS_1
AAATAGGGTGCTATTG-1	Tumor	DCIS/LCIS_4
AAATCCGATACACGCC-1	Invasive	IDC_2
AAATCGTGTACCACAA-1	Tumor	DCIS/LCIS_3
AAATCTAGCCCTGCTA-1	Invasive	IDC_2
AAATGATTCGATCAGC-1	Healthy	Healthy_1
AAATGCTCGTTACGTT-1	Invasive	IDC_5
AAATGGCATGTCTTGT-1	Surrounding tumor	Tumor_edge_1
AAATGGCCCGTGCCCT-1	Invasive	IDC_3
AAATGGTCAATGTGCC-1	Tumor	DCIS/LCIS_3
AAATGTGGGTGCTCCT-1	Tumor	DCIS/LCIS_5
AAATTAACGGGTAGCT-1	Tumor	DCIS/LCIS_3
AAATTACACGACTCTG-1	Surrounding tumor	Tumor_edge_1
AAATTACCTATCGATG-1	Healthy	Healthy_1
AAATTCCAGGTCCAAA-1	Tumor	DCIS/LCIS_1
AAATTGATAGTCCTTT-1	Invasive	IDC_4
AAATTGCGGCGGTTCT-1	Invasive	IDC_5
AAATTGGTGAGAAGCA-1	Healthy	Healthy_1
AAATTTACCGAAATCC-1	Healthy	Healthy_1
AAATTTGCGGGTGTGG-1	Tumor	DCIS/LCIS_3
AACAACTGGTAGTTGC-1	Invasive	IDC_6
AACAATACATTGTCGA-1	Invasive	IDC_4
AACAATTACTCTACGC-1	Tumor	DCIS/LCIS_3
AACACACGCTCGCCGC-1	Invasive	IDC_2
AACACGACTGTACTGA-1	Tumor	DCIS/LCIS_5
AACACGAGACGCGGCC-1	Surrounding tumor	Tumor_edge_2
AACACGCGGCCGCGAA-1	Invasive	IDC_5
AACAGCTGTGTGGCAA-1	Invasive	IDC_4
AACAGGAAATCGAATA-1	Surrounding tumor	Tumor_edge_1
AACAGGATGGGCCGCG-1	Tumor	DCIS/LCIS_3
AACAGGTAGTATGGAT-1	Surrounding tumor	Tumor_edge_3
AACATATCAACTGGTG-1	Healthy	Healthy_1
AACATCGATACGTCTA-1	Healthy	Healthy_1
AACATTGAAGTTGATC-1	Invasive	IDC_4
AACATTGTGACTCGAG-1	Invasive	IDC_4
AACCAAGACTTCTCTG-1	Tumor	DCIS/LCIS_3
AACCAGTATCACTCTT-1	Healthy	Healthy_1
AACCATAGGGTTGAAC-1	Invasive	IDC_4
AACCATGGGATCGCTA-1	Invasive	IDC_5
AACCCAGAGACGGAGA-1	Invasive	IDC_5
AACCCATCCCATGATC-1	Invasive	IDC_4
AACCCGACAACCCGTG-1	Invasive	IDC_4
AACCCGAGCAGAATCG-1	Tumor	DCIS/LCIS_2
AACCCGCTGTATTCCA-1	Invasive	IDC_4
AACCCTACTGTCAATA-1	Surrounding tumor	Tumor_edge_3
AACCCTGGTGGAACCA-1	Tumor	DCIS/LCIS_5
AACCGAGCTTGGTCAT-1	Invasive	IDC_7
AACCGCTAAGGGATGC-1	Surrounding tumor	Tumor_edge_5
AACCGTTGTGTTTGCT-1	Surrounding tumor	Tumor_edge_1
AACCTCGCTTTAGCCC-1	Surrounding tumor	Tumor_edge_6
AACCTGTCACGGAATT-1	Tumor	DCIS/LCIS_1
AACCTTTAAATACGGT-1	Tumor	DCIS/LCIS_4
AACCTTTACGACGTCT-1	Healthy	Healthy_1
AACGATAATGCCGTAG-1	Tumor	DCIS/LCIS_4
AACGATAGAAGGGCCG-1	Invasive	IDC_5
AACGATATGTCAACTG-1	Invasive	IDC_7
AACGCATGATCTGGGT-1	Healthy	Healthy_1
AACGCGAACGGCAACA-1	Invasive	IDC_5
AACGCGACCTTGGGCG-1	Invasive	IDC_4
AACGCGGTCTCCAGCC-1	Invasive	IDC_7
AACGCTGTTGCTGAAA-1	Invasive	IDC_2
AACGGACGTACGTATA-1	Surrounding tumor	Tumor_edge_5
AACGGCCATCTCCGGT-1	Tumor	DCIS/LCIS_3
AACGTACTGTGGGTAC-1	Tumor	DCIS/LCIS_3
AACGTCAGACTAGTGG-1	Invasive	IDC_6
AACGTCGCTGCACTTC-1	Invasive	IDC_2
AACGTGATGAAGGACA-1	Surrounding tumor	Tumor_edge_1
AACGTGCGAAAGTCTC-1	Invasive	IDC_6
AACTACCCGTTTGTCA-1	Surrounding tumor	Tumor_edge_3
AACTAGGCTTGGGTGT-1	Tumor	DCIS/LCIS_4
AACTCAAGTTAATTGC-1	Tumor	DCIS/LCIS_3
AACTCCAGAGCGTGTT-1	Invasive	IDC_2
AACTCCTAATCCCATG-1	Surrounding tumor	Tumor_edge_6
AACTCGATGGCGCAGT-1	Invasive	IDC_5
AACTCTCAATAGAGCG-1	Healthy	Healthy_1
AACTGAGGTCAGCGTC-1	Healthy	Healthy_1
AACTGATATTAGGCCT-1	Invasive	IDC_5
AACTGGGTCCCGACGT-1	Surrounding tumor	Tumor_edge_6
AACTGGTGTGGGCCTT-1	Surrounding tumor	Tumor_edge_6
AACTTCTGCGTCTATC-1	Invasive	IDC_5
AACTTGCCCGTATGCA-1	Tumor	DCIS/LCIS_3
AACTTGCGTTCTCGCG-1	Invasive	IDC_5
AACTTTAGCTGCTGAG-1	Surrounding tumor	Tumor_edge_1
AAGAAGGATCAGTTAG-1	Invasive	IDC_5
AAGACATACGTGGTTT-1	Invasive	IDC_2
AAGACCCAACTGAACA-1	Tumor	DCIS/LCIS_4
AAGACTAACCCGTTGT-1	Invasive	IDC_5
AAGACTGCAAGCTACT-1	Invasive	IDC_6
AAGAGATGAATCGGTA-1	Surrounding tumor	Tumor_edge_2
AAGAGCTCTTTATCGG-1	Invasive	IDC_6
AAGAGGATGTACGCGA-1	Tumor	DCIS/LCIS_3
AAGAGGCATGGATCGC-1	Invasive	IDC_6
AAGAGGCCCTTTGGAA-1	Surrounding tumor	Tumor_edge_4
AAGATGGCACCGGACC-1	Invasive	IDC_4
AAGATTGGCGGAACGT-1	Healthy	Healthy_1
AAGCACCCTGCGTATC-1	Tumor	DCIS/LCIS_4
AAGCATACTCTCCTGA-1	Tumor	DCIS/LCIS_4
AAGCCGAAGCGGTTTA-1	Surrounding tumor	Tumor_edge_3
AAGCCGCCGTGAAATC-1	Invasive	IDC_4
AAGCGCAGGGCTTTGA-1	Invasive	IDC_2
AAGCGGCGTCATGGGT-1	Healthy	Healthy_1
AAGCGTCCCTCATCGA-1	Invasive	IDC_4
AAGCTAGATCGAGTAA-1	Healthy	Healthy_2
AAGCTCGTGCCAAGTC-1	Invasive	IDC_6
AAGCTCTTTCATGGTG-1	Tumor	DCIS/LCIS_4
AAGGAGAACTTATAAG-1	Tumor	DCIS/LCIS_5
AAGGAGCGGTTGGTGC-1	Invasive	IDC_6
AAGGATCGATCGCTTG-1	Tumor	DCIS/LCIS_1
AAGGATGAGGGACCTC-1	Healthy	Healthy_1
AAGGCAGGCTGTCTCC-1	Surrounding tumor	Tumor_edge_3
AAGGCGCGTAAAGCTT-1	Surrounding tumor	Tumor_edge_6
AAGGCTGTGCTCATCG-1	Tumor	DCIS/LCIS_3
AAGGGAACGACTGGCT-1	Invasive	IDC_4
AAGGGACAGATTCTGT-1	Healthy	Healthy_1
AAGGGACTATGCATTC-1	Invasive	IDC_4
AAGGTATCCTAATATA-1	Surrounding tumor	Tumor_edge_1
AAGGTGATAAACCAGC-1	Surrounding tumor	Tumor_edge_3
AAGTAGAAGACCGGGT-1	Invasive	IDC_5
AAGTAGTGACGCGAGG-1	Tumor	DCIS/LCIS_3
AAGTCAATTGTCGTCA-1	Tumor	DCIS/LCIS_1
AAGTGACGACCGAATT-1	Tumor	DCIS/LCIS_3
AAGTGAGTCGGGTTTA-1	Invasive	IDC_4
AAGTGCCTTGACTGTA-1	Tumor	DCIS/LCIS_1
AAGTGCGTTAGAATCT-1	Surrounding tumor	Tumor_edge_2
AAGTGCTTCTCTATTG-1	Invasive	IDC_4
AAGTGTTTGGAGACGG-1	Surrounding tumor	Tumor_edge_5
AAGTTCACTCCAAGCT-1	Invasive	IDC_2
AAGTTCAGTCTGCGTA-1	Healthy	Healthy_1
AAGTTCGGCCAACAGG-1	Tumor	DCIS/LCIS_3
AAGTTGTGATGTTATA-1	Invasive	IDC_2
AAGTTTACTAATGGCA-1	Tumor	DCIS/LCIS_5
AAGTTTATGGGCCCAA-1	Invasive	IDC_2
AATAACAACGCTCGGC-1	Tumor	DCIS/LCIS_3
AATAACGTCGCGCCCA-1	Invasive	IDC_2
AATAAGTCCTCGAGAC-1	Tumor	DCIS/LCIS_5
AATACAATGTTTCAGG-1	Surrounding tumor	Tumor_edge_2
AATACCGGAGGGCTGT-1	Surrounding tumor	Tumor_edge_6
AATACCTGATGTGAAC-1	Invasive	IDC_2
AATAGAATCTGTTTCA-1	Surrounding tumor	Tumor_edge_5
AATAGCAAGCCTCCTG-1	Healthy	Healthy_1
AATAGCTACCGCGTGC-1	Healthy	Healthy_1
AATAGTCCGTCCCGAC-1	Tumor	DCIS/LCIS_4
AATATCAAGGTCGGAT-1	Invasive	IDC_5
AATATCGAATCAATGC-1	Surrounding tumor	Tumor_edge_3
AATATCGAGGGTTCTC-1	Healthy	Healthy_1
AATATTGGAGTATTGA-1	Tumor	DCIS/LCIS_3
AATCAGACTGCAGGAC-1	Invasive	IDC_5
AATCAGGTTTCATTTA-1	Invasive	IDC_4
AATCATGTAAAGACTC-1	Invasive	IDC_2
AATCCAAGGGCCTGAG-1	Invasive	IDC_5
AATCCATGCAAGGGTG-1	Invasive	IDC_5
AATCGCCTCAGCGCCA-1	Invasive	IDC_6
AATCGCGCAGAGGACT-1	Tumor	DCIS/LCIS_1
AATCGGGACACTACGA-1	Tumor	DCIS/LCIS_5
AATCGGTATAGCCCTC-1	Invasive	IDC_2
AATCGTGAGCCGAGCA-1	Invasive	IDC_2
AATCTAGGTTTACTTG-1	Invasive	IDC_3
AATCTATGCCGGAGCC-1	Surrounding tumor	Tumor_edge_6
AATCTGCGTTGGGACG-1	Healthy	Healthy_1
AATCTGGCTTTCTAGT-1	Invasive	IDC_3
AATCTGGGTAGACCCT-1	Surrounding tumor	Tumor_edge_6
AATGACAGCAATGTCT-1	Surrounding tumor	Tumor_edge_2
AATGACTGTCAGCCGG-1	Invasive	IDC_5
AATGAGTTCGCATATG-1	Invasive	IDC_5
AATGATGATACGCTAT-1	Healthy	Healthy_1
AATGATGCGACTCCTG-1	Healthy	Healthy_1
AATGCAACCGGGTACC-1	Invasive	IDC_7
AATGCACCAAGCAATG-1	Healthy	Healthy_1
AATGGTCCACCGTTCA-1	Surrounding tumor	Tumor_edge_2
AATGGTTCTCACAAGC-1	Invasive	IDC_5
AATGTATGGCACTGTA-1	Invasive	IDC_4
AATGTGCCCGAGGTGT-1	Invasive	IDC_4
AATGTGCTAATCTGAG-1	Invasive	IDC_4
AATGTTGTCGTGAGAC-1	Invasive	IDC_2
AATTAAAGGTCGGCGT-1	Tumor	DCIS/LCIS_3
AATTAACGGATTTCCA-1	Tumor	DCIS/LCIS_4
AATTCATAAGGGATCT-1	Healthy	Healthy_1
AATTCATTGTCATGCA-1	Invasive	IDC_4
AATTCCAAGCATGTAC-1	Surrounding tumor	Tumor_edge_6
AATTCGATTCGAGGAT-1	Invasive	IDC_2
AATTGCAGCAATCGAC-1	Invasive	IDC_2
AATTGCGTGGATTACA-1	Invasive	IDC_4
AATTTGGGACATAGTA-1	Surrounding tumor	Tumor_edge_1
AATTTGGTTCCAAAGA-1	Surrounding tumor	Tumor_edge_6
ACAAACCATGCGTCCT-1	Invasive	IDC_4
ACAAAGCATGACCTAG-1	Invasive	IDC_2
ACAAATCGCACCGAAT-1	Surrounding tumor	Tumor_edge_5
ACAAATTCAGATCTGA-1	Healthy	Healthy_1
ACAACAGCATGAGCTA-1	Surrounding tumor	Tumor_edge_6
ACAACGGTCCCTGCGA-1	Invasive	IDC_5
ACAAGCAGTGCCTAGC-1	Tumor	DCIS/LCIS_3
ACAAGGAAATCCGCCC-1	Healthy	Healthy_2
ACAAGGACAAGAGGTT-1	Tumor	DCIS/LCIS_3
ACAAGGATGCTTTAGG-1	Invasive	IDC_2
ACAATAGTCGTACGTT-1	Surrounding tumor	Tumor_edge_2
ACAATCCATTTAAACC-1	Tumor	DCIS/LCIS_3
ACAATCGATCTTTATA-1	Tumor	DCIS/LCIS_5
ACAATGAATACGGAGA-1	Invasive	IDC_4
ACAATGATTCTTCTAC-1	Healthy	Healthy_1
ACAATTGTGTCTCTTT-1	Invasive	IDC_2
ACAATTTGAGCAGTGG-1	Invasive	IDC_7
ACACAAAGACGGGTGG-1	Surrounding tumor	Tumor_edge_6
ACACACCAGGACCAGT-1	Invasive	IDC_1
ACACACTTTCTACACG-1	Invasive	IDC_5
ACACATGATCAAATCT-1	Invasive	IDC_4
ACACATTTCCGTAGAC-1	Invasive	IDC_4
ACACCACATAATTAGC-1	Surrounding tumor	Tumor_edge_3
ACACCCAGCATGCAGC-1	Invasive	IDC_5
ACACCCGAGAAATCCG-1	Invasive	IDC_5
ACACCGGTCTGACCGC-1	Invasive	IDC_4
ACACCTTAAGTAGGGC-1	Invasive	IDC_6
ACACCTTACTACTTGC-1	Tumor	DCIS/LCIS_1
ACACGAGACTCCTTCT-1	Invasive	IDC_7
ACACGGCACTATGCAT-1	Tumor	DCIS/LCIS_5
ACACGGGAACTTAGGG-1	Invasive	IDC_7
ACACGTAGGCCACAAG-1	Tumor	DCIS/LCIS_2
ACACTCCAATGTCACT-1	Invasive	IDC_5
ACACTGGGACAGTCGT-1	Tumor	DCIS/LCIS_2
ACAGAACTGAGAACAA-1	Invasive	IDC_3
ACAGATTAGGTTAGTG-1	Surrounding tumor	Tumor_edge_1
ACAGCATAGAGCCAGT-1	Invasive	IDC_5
ACAGCGACATTCTCAT-1	Invasive	IDC_2
ACAGCGCACCCGCAGC-1	Tumor	DCIS/LCIS_5
ACAGGCACGGATCCTT-1	Invasive	IDC_2
ACAGGCTTGCCCGACT-1	Invasive	IDC_2
ACAGTAATACAACTTG-1	Invasive	IDC_3
ACAGTATACCGTGGGA-1	Healthy	Healthy_1
ACATAATAAGGCGGTG-1	Invasive	IDC_5
ACATCCCGGCCATACG-1	Healthy	Healthy_2
ACATCCTGGTAACTGT-1	Tumor	DCIS/LCIS_1
ACATCGATCGTTTACC-1	Tumor	DCIS/LCIS_3
ACATCGGTCAGCCGCG-1	Tumor	DCIS/LCIS_3
ACATCGTTAACCTAGT-1	Tumor	DCIS/LCIS_5
ACATCTCAACGCGTAA-1	Tumor	DCIS/LCIS_5
ACATGGCGCCAAAGTA-1	Tumor	DCIS/LCIS_1
ACATGGCTCAATTTAG-1	Invasive	IDC_5
ACATTTGAAACCTAAC-1	Invasive	IDC_2
ACCAAACACCCAGCGA-1	Healthy	Healthy_1
ACCAAACTAGAAATCC-1	Tumor	DCIS/LCIS_5
ACCAACACCACACACT-1	Healthy	Healthy_1
ACCAACCGCACTCCAC-1	Invasive	IDC_2
ACCAAGAACGCGTGTC-1	Invasive	IDC_5
ACCAAGTCATCGGCAG-1	Invasive	IDC_2
ACCAATATGCAAGTTA-1	Tumor	DCIS/LCIS_4
ACCACAACTCAGAACA-1	Tumor	DCIS/LCIS_5
ACCACAAGTTTCTATC-1	Invasive	IDC_6
ACCACACGGTTGATGG-1	Invasive	IDC_4
ACCACCAATGTAACAA-1	Tumor	DCIS/LCIS_1
ACCACCCTCTCTTCTA-1	Healthy	Healthy_1
ACCACGTGCAGCTATA-1	Healthy	Healthy_2
ACCAGCCCGGTCTTTG-1	Tumor	DCIS/LCIS_5
ACCAGGAGTGTGATCT-1	Tumor	DCIS/LCIS_5
ACCAGTGCCCGGTCAA-1	Healthy	Healthy_1
ACCAGTGCGGGAGACG-1	Surrounding tumor	Tumor_edge_5
ACCATATCCGCAATAA-1	Tumor	DCIS/LCIS_3
ACCATCCGCCAACTAG-1	Surrounding tumor	Tumor_edge_2
ACCATCGTATATGGTA-1	Tumor	DCIS/LCIS_3
ACCCAACGCCCGTGGC-1	Invasive	IDC_7
ACCCACCTACATGCTC-1	Surrounding tumor	Tumor_edge_2
ACCCATCTTGAGGGTA-1	Tumor	DCIS/LCIS_3
ACCCATTTGTCCCTCT-1	Invasive	IDC_2
ACCCGAGCGAAATTAC-1	Invasive	IDC_4
ACCCGATTGGTTCCGA-1	Surrounding tumor	Tumor_edge_6
ACCCGGAAACTCCCAG-1	Tumor	DCIS/LCIS_4
ACCCGGATGACGCATC-1	Tumor	DCIS/LCIS_1
ACCCGGTTACACTTCC-1	Tumor	DCIS/LCIS_3
ACCCGTAGTCTAGTTG-1	Surrounding tumor	Tumor_edge_6
ACCCGTGTCATCAGTA-1	Healthy	Healthy_2
ACCCTATAGGACTGAG-1	Invasive	IDC_5
ACCCTCCCGTCAGGGC-1	Invasive	IDC_2
ACCCTCCCTTGCTATT-1	Surrounding tumor	Tumor_edge_5
ACCCTGGTAACGCCCT-1	Healthy	Healthy_1
ACCCTTCATCTGCGAA-1	Surrounding tumor	Tumor_edge_1
ACCCTTTAGTTCTCCA-1	Tumor	DCIS/LCIS_5
ACCGAAAGGGCCCTGC-1	Invasive	IDC_5
ACCGAAGAGTCTGGTT-1	Invasive	IDC_4
ACCGACACATCTCCCA-1	Tumor	DCIS/LCIS_4
ACCGACTGAGTCCCAC-1	Invasive	IDC_7
ACCGAGTCTCCTTATT-1	Invasive	IDC_2
ACCGATAGGCATAACC-1	Surrounding tumor	Tumor_edge_4
ACCGATATTTAATCAT-1	Surrounding tumor	Tumor_edge_3
ACCGATGGTAGCATCG-1	Invasive	IDC_1
ACCGCAATAACTGCCT-1	Surrounding tumor	Tumor_edge_5
ACCGCGGTGGAAGTCG-1	Tumor	DCIS/LCIS_1
ACCGGGCCTTTGTTGA-1	Surrounding tumor	Tumor_edge_6
ACCGGTCAGGTACACC-1	Invasive	IDC_4
ACCGTGACCACGTGGG-1	Invasive	IDC_4
ACCGTTCCCGCTCTGA-1	Tumor	DCIS/LCIS_5
ACCTAAGTACCTTTCA-1	Surrounding tumor	Tumor_edge_2
ACCTAATCGACTTCCT-1	Tumor	DCIS/LCIS_3
ACCTACAGTATGTGGT-1	Tumor	DCIS/LCIS_1
ACCTACTATAAATCTA-1	Invasive	IDC_4
ACCTCCGCCCTCGCTG-1	Tumor	DCIS/LCIS_2
ACCTCCGTTATTCACC-1	Tumor	DCIS/LCIS_1
ACCTCGAACTTATGCT-1	Invasive	IDC_4
ACCTGCGTGTCATGTT-1	Surrounding tumor	Tumor_edge_2
ACCTTTCCTTTAGAAG-1	Tumor	DCIS/LCIS_5
ACGAAATGGGCGGCAC-1	Tumor	DCIS/LCIS_3
ACGACTCTAGGGCCGA-1	Invasive	IDC_2
ACGACTGGTCATACTC-1	Invasive	IDC_4
ACGAGAACCCATCACG-1	Invasive	IDC_5
ACGAGATATTTGCTTA-1	Tumor	DCIS/LCIS_5
ACGAGGATACCACTCT-1	Invasive	IDC_3
ACGAGGTTTACAACGT-1	Invasive	IDC_4
ACGAGTACGGATGCCC-1	Surrounding tumor	Tumor_edge_3
ACGATACATAGAACTA-1	Surrounding tumor	Tumor_edge_1
ACGATCATACATAGAG-1	Invasive	IDC_7
ACGATCATCTTGTAAA-1	Tumor	DCIS/LCIS_1
ACGATGCATATGTTAT-1	Tumor	DCIS/LCIS_3
ACGATGGATCCGATGC-1	Tumor	DCIS/LCIS_5
ACGCAAACTAATAGAT-1	Invasive	IDC_4
ACGCAATCACTACAGC-1	Healthy	Healthy_1
ACGCATAAATGACATG-1	Healthy	Healthy_1
ACGCATACGTTTACTA-1	Surrounding tumor	Tumor_edge_4
ACGCATTCGTGAGTAC-1	Invasive	IDC_6
ACGCCACTCGAAACAG-1	Invasive	IDC_4
ACGCCAGATGATTTCT-1	Surrounding tumor	Tumor_edge_1
ACGCCAGTGCGTTTGC-1	Invasive	IDC_2
ACGCCCAGCTGTCGAT-1	Tumor	DCIS/LCIS_5
ACGCCGCTAGACGACC-1	Healthy	Healthy_2
ACGCGCTACACAGGGT-1	Tumor	DCIS/LCIS_3
ACGCGGGCCAAGGACA-1	Invasive	IDC_6
ACGCTAGTGATACACT-1	Healthy	Healthy_1
ACGCTGTGAGGCGTAG-1	Surrounding tumor	Tumor_edge_2
ACGCTTAGTGTCTCTC-1	Surrounding tumor	Tumor_edge_6
ACGGAACACGAGTGCC-1	Invasive	IDC_2
ACGGAATTTAGCAAAT-1	Invasive	IDC_5
ACGGACTCTCAAAGCG-1	Tumor	DCIS/LCIS_4
ACGGAGCGCAAATTAC-1	Healthy	Healthy_1
ACGGATGGTGCGGATA-1	Tumor	DCIS/LCIS_4
ACGGCGACGATGGGAA-1	Healthy	Healthy_2
ACGGCGGGTTGCCCTG-1	Invasive	IDC_5
ACGGCTGGATGTAGAA-1	Invasive	IDC_4
ACGGGAGTGTCGGCCC-1	Surrounding tumor	Tumor_edge_2
ACGGGCGTATGCGACA-1	Healthy	Healthy_1
ACGGTACAGTTCAATG-1	Invasive	IDC_2
ACGGTCACCGAGAACA-1	Invasive	IDC_4
ACGTACAGATTTCTCT-1	Tumor	DCIS/LCIS_5
ACGTACTTTGGCACGG-1	Surrounding tumor	Tumor_edge_6
ACGTAGATTGCTGATG-1	Invasive	IDC_6
ACGTAGGAGAGTCGCT-1	Invasive	IDC_2
ACGTATTACTCCGATC-1	Tumor	DCIS/LCIS_1
ACGTCCTAAACGAGAT-1	Tumor	DCIS/LCIS_5
ACGTGCGCCTCGTGCA-1	Invasive	IDC_5
ACGTTAATGTCGAAGA-1	Invasive	IDC_6
ACGTTAGATTTGCCCG-1	Tumor	DCIS/LCIS_3
ACGTTATTGGTCACTC-1	Invasive	IDC_5
ACGTTCCGCGCTCCGT-1	Surrounding tumor	Tumor_edge_1
ACGTTCGCAATCAATT-1	Tumor	DCIS/LCIS_1
ACGTTCGTTCAGGAAA-1	Invasive	IDC_4
ACGTTCTGTACAAGTC-1	Invasive	IDC_2
ACGTTTAGTTGTGATC-1	Surrounding tumor	Tumor_edge_1
ACTAATACGTCAGGCG-1	Healthy	Healthy_1
ACTACAAAGAGAGGTG-1	Invasive	IDC_4
ACTACATCCCGACAAG-1	Invasive	IDC_4
ACTACCAGCTCTCTGG-1	Invasive	IDC_6
ACTACGCGTTAGAATT-1	Tumor	DCIS/LCIS_4
ACTAGTTGCGATCGTC-1	Surrounding tumor	Tumor_edge_5
ACTATATGCTGTGTTC-1	Healthy	Healthy_1
ACTATCCAGGGCATGG-1	Tumor	DCIS/LCIS_1
ACTATCTGCCCGCGTA-1	Surrounding tumor	Tumor_edge_5
ACTATGTCCAGCTGCC-1	Invasive	IDC_4
ACTATTCGTCCGTGGT-1	Surrounding tumor	Tumor_edge_1
ACTATTTCCGGGCCCA-1	Invasive	IDC_4
ACTCAACGAATGTATT-1	Invasive	IDC_5
ACTCAAGTGCAAGGCT-1	Invasive	IDC_2
ACTCAATAAAGGCACG-1	Invasive	IDC_7
ACTCAGACCTGCTTCT-1	Invasive	IDC_5
ACTCATGGCAGCCTTC-1	Invasive	IDC_4
ACTCCAATATCATCAT-1	Invasive	IDC_4
ACTCCCATTCCTAAAG-1	Invasive	IDC_3
ACTCCCGAATTCGTTT-1	Surrounding tumor	Tumor_edge_6
ACTCCCGTAGACTAGG-1	Healthy	Healthy_1
ACTCCCTAATGCTAAA-1	Tumor	DCIS/LCIS_4
ACTCCGGCCGACCACT-1	Invasive	IDC_2
ACTCGCCGTTCGATAA-1	Invasive	IDC_2
ACTCGTAACCCGTCCT-1	Surrounding tumor	Tumor_edge_2
ACTCGTCAGTAATCCC-1	Invasive	IDC_6
ACTCTCTGACTTAGGT-1	Invasive	IDC_1
ACTCTCTTATACACGA-1	Surrounding tumor	Tumor_edge_1
ACTCTGACCTAATAGA-1	Invasive	IDC_2
ACTCTTGTATAGTAAC-1	Invasive	IDC_6
ACTGAAACGCCGTTAG-1	Invasive	IDC_2
ACTGAATGGCGAAAGT-1	Surrounding tumor	Tumor_edge_5
ACTGATTTAGTGATTC-1	Tumor	DCIS/LCIS_5
ACTGCCCGCCATTCTC-1	Invasive	IDC_4
ACTGCCGTCGTAACTC-1	Surrounding tumor	Tumor_edge_1
ACTGCGGACACACCGT-1	Tumor	DCIS/LCIS_1
ACTGGGATGCCAGTGC-1	Invasive	IDC_4
ACTGTACGATACACAT-1	Invasive	IDC_7
ACTGTAGCACTTTGGA-1	Invasive	IDC_6
ACTGTATACGCGAGCA-1	Invasive	IDC_5
ACTGTCCAGGATTATA-1	Tumor	DCIS/LCIS_3
ACTGTCTTCTTTAGAA-1	Invasive	IDC_6
ACTGTGCTAGTAGATC-1	Invasive	IDC_5
ACTGTTTAGTGTAGGC-1	Tumor	DCIS/LCIS_5
ACTTACCGGGCGCGCA-1	Healthy	Healthy_1
ACTTACGCATCCACGC-1	Tumor	DCIS/LCIS_4
ACTTAGTACGACAAGA-1	Invasive	IDC_5
ACTTATACTTACCCGG-1	Invasive	IDC_1
ACTTATTAGGATCGGT-1	Tumor	DCIS/LCIS_3
ACTTATTTATGTGCCA-1	Surrounding tumor	Tumor_edge_5
ACTTCAGGCTGATCCC-1	Surrounding tumor	Tumor_edge_5
ACTTCCATGCGGGACA-1	Invasive	IDC_2
ACTTCGCCATACGCAC-1	Invasive	IDC_7
ACTTGACTCCCTCTTT-1	Healthy	Healthy_2
ACTTGCCATATTGTAC-1	Tumor	DCIS/LCIS_5
ACTTGGGACCCGGTGG-1	Invasive	IDC_6
ACTTGTAGTCCCTTCA-1	Surrounding tumor	Tumor_edge_2
ACTTGTGGATGGAACG-1	Surrounding tumor	Tumor_edge_5
ACTTGTTACCGGATCA-1	Surrounding tumor	Tumor_edge_6
ACTTTACCCTCATGAA-1	Tumor	DCIS/LCIS_1
ACTTTCCTATAGCTTC-1	Invasive	IDC_7
ACTTTGACTGCATCCT-1	Surrounding tumor	Tumor_edge_2
ACTTTGGTCGTGCTCC-1	Invasive	IDC_4
AGAAATTATGACTCGC-1	Surrounding tumor	Tumor_edge_5
AGAACCCTCAATTGGG-1	Invasive	IDC_4
AGAACGTGGTACATTC-1	Invasive	IDC_7
AGAACTGTACTTTGTA-1	Invasive	IDC_2
AGAAGAGCGCCGTTCC-1	Invasive	IDC_1
AGAAGGTACACTTCAC-1	Invasive	IDC_3
AGAAGGTTGCCGAATT-1	Tumor	DCIS/LCIS_3
AGAAGGTTGTAGGTCG-1	Invasive	IDC_2
AGAAGTGATTCGTGAT-1	Surrounding tumor	Tumor_edge_2
AGAATACAGGCTATCC-1	Surrounding tumor	Tumor_edge_6
AGAATGCGGGTTCGGA-1	Healthy	Healthy_1
AGAATTATGGATTCGA-1	Healthy	Healthy_1
AGAATTGTTTGACATA-1	Invasive	IDC_5
AGACATAGATCCTTCC-1	Invasive	IDC_5
AGACCATGGGATACAA-1	Invasive	IDC_5
AGACCCGCCCTCCTCG-1	Surrounding tumor	Tumor_edge_6
AGACCGCTCCGCGGTT-1	Surrounding tumor	Tumor_edge_5
AGACCGGGAAACCCTG-1	Surrounding tumor	Tumor_edge_2
AGACGAAGTGCCGGTC-1	Surrounding tumor	Tumor_edge_5
AGACGACGATGCCGCT-1	Invasive	IDC_4
AGACGGGCCGATTTAA-1	Healthy	Healthy_1
AGACTAGCCTTCCAGA-1	Invasive	IDC_6
AGACTGTTACCGGGTC-1	Invasive	IDC_4
AGAGAAACACCAGAAA-1	Invasive	IDC_4
AGAGAACCGTCTAGGA-1	Healthy	Healthy_1
AGAGAAGGAGTACAAT-1	Invasive	IDC_4
AGAGATCTCTAAAGCG-1	Surrounding tumor	Tumor_edge_2
AGAGCAGTTATGAGAC-1	Surrounding tumor	Tumor_edge_2
AGAGCCGCCGAGATTT-1	Tumor	DCIS/LCIS_2
AGAGCGGGCTAATCAT-1	Invasive	IDC_5
AGAGCGTACAAGCTCG-1	Surrounding tumor	Tumor_edge_6
AGAGCTACGAAAGCAT-1	Invasive	IDC_5
AGAGGCTTCGGAAACC-1	Surrounding tumor	Tumor_edge_5
AGAGGGACAATTGTCC-1	Healthy	Healthy_1
AGAGGTATCTCGGTCC-1	Tumor	DCIS/LCIS_5
AGAGTAAACTTCACTA-1	Surrounding tumor	Tumor_edge_3
AGAGTATAGTGTTACG-1	Healthy	Healthy_1
AGAGTTAGAGACCGAT-1	Healthy	Healthy_1
AGATAACTTCAGGGCC-1	Tumor	DCIS/LCIS_3
AGATACCAATAGAACC-1	Invasive	IDC_2
AGATACCAGCACTTCA-1	Healthy	Healthy_1
AGATACCGGTGTTCAC-1	Tumor	DCIS/LCIS_3
AGATACGACTTCATAT-1	Invasive	IDC_5
AGATATAATACGACTA-1	Surrounding tumor	Tumor_edge_6
AGATCGTGCATAAGAT-1	Healthy	Healthy_1
AGATCTCAGGTGTGAT-1	Invasive	IDC_7
AGATGACTCGCCCACG-1	Invasive	IDC_5
AGATGAGGGTTGCGAT-1	Healthy	Healthy_1
AGATGATGGAGTCTGG-1	Tumor	DCIS/LCIS_1
AGATGCAAGACGTGCA-1	Invasive	IDC_4
AGATTATAGGACGTTT-1	Tumor	DCIS/LCIS_3
AGATTCACAACCGATA-1	Invasive	IDC_3
AGCAAAGGCCGCTAGT-1	Tumor	DCIS/LCIS_4
AGCAACATATCTTATT-1	Surrounding tumor	Tumor_edge_6
AGCAACCGAAAGTAAT-1	Invasive	IDC_4
AGCACACGTTTAGACT-1	Invasive	IDC_4
AGCACCAGTACTCACG-1	Invasive	IDC_7
AGCACTACCGGCCTGT-1	Tumor	DCIS/LCIS_3
AGCACTACCTCACCAG-1	Tumor	DCIS/LCIS_4
AGCACTTAAGGACGCC-1	Tumor	DCIS/LCIS_3
AGCAGAAGGAGAAAGA-1	Tumor	DCIS/LCIS_4
AGCAGCCAGATGAATA-1	Tumor	DCIS/LCIS_4
AGCAGTCGAAGCATGC-1	Invasive	IDC_4
AGCATATCAATATGCT-1	Invasive	IDC_2
AGCATCATTTCGAAAG-1	Invasive	IDC_3
AGCATCGTCGATAATT-1	Invasive	IDC_5
AGCATTACGAGGCAAG-1	Invasive	IDC_2
AGCCAAGCTTTGTGTC-1	Tumor	DCIS/LCIS_4
AGCCACAGGTTACCCG-1	Invasive	IDC_2
AGCCACTCCCGTGCTT-1	Surrounding tumor	Tumor_edge_1
AGCCATATAGTATGTG-1	Surrounding tumor	Tumor_edge_6
AGCCCATACATGTAAG-1	Tumor	DCIS/LCIS_3
AGCCCGCAACAAGCAG-1	Invasive	IDC_4
AGCCCGCACTACAATG-1	Invasive	IDC_2
AGCCCGGCATTAGAGG-1	Invasive	IDC_4
AGCCCGGTAGCCTGTA-1	Invasive	IDC_4
AGCCCTAAGCGAAGTT-1	Invasive	IDC_5
AGCCCTCCCTGGTGGC-1	Invasive	IDC_4
AGCCCTTCTAATCCGA-1	Healthy	Healthy_1
AGCCCTTGGACATCCC-1	Surrounding tumor	Tumor_edge_4
AGCCGTGGCTAAATGT-1	Invasive	IDC_3
AGCCTAATACCCACGT-1	Invasive	IDC_3
AGCCTTAAAGCGGAAG-1	Surrounding tumor	Tumor_edge_6
AGCGACATCCCATTCA-1	Invasive	IDC_5
AGCGACCAACGATATT-1	Surrounding tumor	Tumor_edge_6
AGCGAGACGTGAAGGC-1	Invasive	IDC_4
AGCGATGCGCCTAATA-1	Invasive	IDC_2
AGCGCATAATGAATCG-1	Healthy	Healthy_2
AGCGCGGGTGCCAATG-1	Healthy	Healthy_1
AGCGCTTATGGGCAAG-1	Healthy	Healthy_1
AGCGGACACTTCGTAG-1	Tumor	DCIS/LCIS_4
AGCGGCGGTTAGCGGT-1	Invasive	IDC_3
AGCGGGAAGGGTCCAT-1	Invasive	IDC_5
AGCGGGTCTGACACTC-1	Surrounding tumor	Tumor_edge_6
AGCGGTTGCCGCTCTG-1	Healthy	Healthy_1
AGCGTACGAGAGCTAG-1	Invasive	IDC_5
AGCGTCTGAACCCGCA-1	Invasive	IDC_5
AGCTAACAAGCAATGT-1	Invasive	IDC_4
AGCTAAGTACGCAGGC-1	Invasive	IDC_2
AGCTAGAAGCAGAAGT-1	Healthy	Healthy_1
AGCTATTTAATCCAAC-1	Surrounding tumor	Tumor_edge_1
AGCTCCATATATGTTC-1	Tumor	DCIS/LCIS_2
AGCTCCTTCGCACATC-1	Invasive	IDC_2
AGCTCTAGACGTTCCA-1	Invasive	IDC_6
AGCTCTTCCCAGTGCA-1	Surrounding tumor	Tumor_edge_1
AGCTCTTCGTAACCTT-1	Tumor	DCIS/LCIS_1
AGCTCTTTACTCAGTT-1	Tumor	DCIS/LCIS_3
AGCTGAAGTAAACCAA-1	Surrounding tumor	Tumor_edge_1
AGCTGTAACCTCAATC-1	Invasive	IDC_4
AGCTTATAGAGACCTG-1	Surrounding tumor	Tumor_edge_1
AGCTTCTTCTCGAGCA-1	Invasive	IDC_2
AGCTTGATCTTAACTT-1	Surrounding tumor	Tumor_edge_6
AGGAAGCTGTCCGCCG-1	Tumor	DCIS/LCIS_4
AGGACATCGCACGTCG-1	Invasive	IDC_5
AGGACGACCCATTAGA-1	Tumor	DCIS/LCIS_3
AGGACGCTCGATGTTG-1	Healthy	Healthy_1
AGGAGACATCCACAGT-1	Healthy	Healthy_1
AGGAGGCCTTCGCGCG-1	Invasive	IDC_2
AGGATAAAGTCGGGAT-1	Tumor	DCIS/LCIS_4
AGGATATAGGGATTTA-1	Surrounding tumor	Tumor_edge_3
AGGATATCCGACTGCA-1	Invasive	IDC_2
AGGATCACGCGATCTG-1	Invasive	IDC_3
AGGATTGCTTACGACA-1	Surrounding tumor	Tumor_edge_3
AGGCACGTGACTGTCC-1	Tumor	DCIS/LCIS_2
AGGCAGATGCGTAAAC-1	Surrounding tumor	Tumor_edge_1
AGGCAGGGAGCGTACT-1	Invasive	IDC_4
AGGCATTGTCGTAGGG-1	Surrounding tumor	Tumor_edge_5
AGGCCACCCGTTATGA-1	Surrounding tumor	Tumor_edge_6
AGGCCCAGTGACTGGT-1	Invasive	IDC_5
AGGCCCATTGTACAGG-1	Invasive	IDC_5
AGGCCCTAGAACGCCA-1	Surrounding tumor	Tumor_edge_2
AGGCCTATCATACCAA-1	Invasive	IDC_4
AGGCCTGAGAATCTCG-1	Invasive	IDC_2
AGGCGGTTTGTCCCGC-1	Invasive	IDC_4
AGGCGTCTATGGACGG-1	Healthy	Healthy_1
AGGCTATGGTTAGCTT-1	Surrounding tumor	Tumor_edge_2
AGGCTTGCTAGACACC-1	Surrounding tumor	Tumor_edge_2
AGGGAAACGAGGTACT-1	Surrounding tumor	Tumor_edge_1
AGGGACCGGCTGCGTT-1	Tumor	DCIS/LCIS_1
AGGGAGACATACTTCG-1	Surrounding tumor	Tumor_edge_3
AGGGCAGCGGCGTGGT-1	Tumor	DCIS/LCIS_5
AGGGCGAGCAGCTGAT-1	Surrounding tumor	Tumor_edge_2
AGGGCGTGATCGGCTA-1	Invasive	IDC_5
AGGGCTGCAGTTACAG-1	Invasive	IDC_6
AGGGTCAGAGCACTCG-1	Invasive	IDC_4
AGGGTCAGTAACCCTA-1	Healthy	Healthy_1
AGGGTCGATGCGAACT-1	Surrounding tumor	Tumor_edge_3
AGGGTGCCGTTCTTTA-1	Invasive	IDC_4
AGGGTGCTCTCGAGGG-1	Healthy	Healthy_1
AGGGTTCAGACGGTCC-1	Invasive	IDC_4
AGGGTTCCCTTTGGTT-1	Invasive	IDC_7
AGGGTTTAGTTCGGGA-1	Invasive	IDC_6
AGGTAACCTCCTATTC-1	Invasive	IDC_5
AGGTACGATATTGCCA-1	Surrounding tumor	Tumor_edge_1
AGGTAGATCGAGATAT-1	Invasive	IDC_4
AGGTAGGTACAAAGCT-1	Tumor	DCIS/LCIS_3
AGGTATAATTGATAGT-1	Tumor	DCIS/LCIS_1
AGGTCAGGTGAGAGTG-1	Surrounding tumor	Tumor_edge_2
AGGTCGCGGAGTTACT-1	Healthy	Healthy_1
AGGTGCACGTCCACAT-1	Invasive	IDC_2
AGGTGGTGACCTTCGC-1	Tumor	DCIS/LCIS_4
AGGTGTATCGCCATGA-1	Surrounding tumor	Tumor_edge_2
AGGTTACACCATGCCG-1	Surrounding tumor	Tumor_edge_3
AGGTTCTCCTTTCCGG-1	Invasive	IDC_4
AGGTTGAGGCACGCTT-1	Invasive	IDC_7
AGGTTTCACACACCTT-1	Invasive	IDC_6
AGTAACGTTCATCCTG-1	Healthy	Healthy_1
AGTAACTATAGCAGCC-1	Invasive	IDC_2
AGTAATCTAAGGGTGG-1	Surrounding tumor	Tumor_edge_6
AGTAATGTCTTGCCGC-1	Invasive	IDC_5
AGTAATTTGCAAGCGT-1	Invasive	IDC_4
AGTACAGAAGCTTATA-1	Invasive	IDC_2
AGTACATCATTTATCA-1	Surrounding tumor	Tumor_edge_3
AGTACCTTCGAGTGCT-1	Healthy	Healthy_1
AGTACGGGCACCTGGC-1	Surrounding tumor	Tumor_edge_1
AGTACGTGGCCTGTCT-1	Surrounding tumor	Tumor_edge_1
AGTACTCTTATGCCCA-1	Invasive	IDC_2
AGTAGAAGGCGCCTCA-1	Invasive	IDC_4
AGTAGCGTGAACGAAC-1	Tumor	DCIS/LCIS_5
AGTAGGAAGGAAGTTG-1	Healthy	Healthy_1
AGTAGGTAACATACAT-1	Invasive	IDC_5
AGTATAATACTAGGCA-1	Invasive	IDC_5
AGTATACACAGCGACA-1	Invasive	IDC_4
AGTATCCATAATAACG-1	Invasive	IDC_5
AGTATGCTGGAGACCA-1	Invasive	IDC_4
AGTCAAATGATGTGAT-1	Invasive	IDC_4
AGTCAACACCACCATC-1	Tumor	DCIS/LCIS_3
AGTCAAGATGACACTT-1	Surrounding tumor	Tumor_edge_5
AGTCACTAGCTCTCGA-1	Invasive	IDC_2
AGTCACTCCGCCTCAT-1	Invasive	IDC_5
AGTCAGCCACCGCCTG-1	Invasive	IDC_5
AGTCCAGCGGGTACGT-1	Invasive	IDC_5
AGTCCATTGGCTGATG-1	Tumor	DCIS/LCIS_1
AGTCCCGCCTTTAATT-1	Healthy	Healthy_1
AGTCGACGGTCTCAAG-1	Invasive	IDC_1
AGTCGGCCCAAACGAC-1	Invasive	IDC_6
AGTCGGCTCAACTTTA-1	Surrounding tumor	Tumor_edge_2
AGTCGGTTGCGTGAGA-1	Tumor	DCIS/LCIS_1
AGTCGTATAAAGCAGA-1	Invasive	IDC_2
AGTCGTCGACCACCAA-1	Invasive	IDC_2
AGTCGTGGGCATTACG-1	Surrounding tumor	Tumor_edge_2
AGTCTAAAGTATACTC-1	Surrounding tumor	Tumor_edge_3
AGTCTCACAAGACTAC-1	Invasive	IDC_4
AGTCTGGACATCCTTG-1	Invasive	IDC_5
AGTCTTCTCCTCAAAT-1	Invasive	IDC_7
AGTCTTTAAAGTGTCC-1	Invasive	IDC_2
AGTGAACAAACTTCTC-1	Tumor	DCIS/LCIS_1
AGTGAAGATGGTGTCC-1	Healthy	Healthy_1
AGTGACCTACTTTACG-1	Tumor	DCIS/LCIS_3
AGTGACTGTGACACAA-1	Invasive	IDC_4
AGTGAGACTTCCAGTA-1	Healthy	Healthy_1
AGTGAGCCTCGCCGCC-1	Surrounding tumor	Tumor_edge_3
AGTGAGGGTTTCTGAC-1	Surrounding tumor	Tumor_edge_1
AGTGAGTCGAATTAAC-1	Invasive	IDC_2
AGTGATAACCTGCGCG-1	Invasive	IDC_2
AGTGATATGAGTAGTT-1	Tumor	DCIS/LCIS_3
AGTGATTCAAGCAGGA-1	Healthy	Healthy_1
AGTGCACGCTTAAGAA-1	Invasive	IDC_2
AGTGCGTAGCTCGTAA-1	Tumor	DCIS/LCIS_3
AGTGCTAAACACAGCA-1	Invasive	IDC_2
AGTGCTTGCACGAATA-1	Invasive	IDC_1
AGTGGCCCGCAAATGG-1	Invasive	IDC_2
AGTGGCGGCAATTTGA-1	Healthy	Healthy_1
AGTGGCGTCTGAAGGT-1	Invasive	IDC_2
AGTGGCTCCGTCGGCC-1	Surrounding tumor	Tumor_edge_2
AGTGTATTGCGCATTG-1	Healthy	Healthy_1
AGTGTGGTCTATTGTG-1	Invasive	IDC_5
AGTTAAACACTTGCGA-1	Tumor	DCIS/LCIS_3
AGTTAAGCGGTCCCGG-1	Surrounding tumor	Tumor_edge_1
AGTTAAGTCAACCGCT-1	Invasive	IDC_3
AGTTACCGCACATGGT-1	Surrounding tumor	Tumor_edge_2
AGTTACTCTATCGTGG-1	Surrounding tumor	Tumor_edge_1
AGTTATTCAGACTGTG-1	Invasive	IDC_2
AGTTCCTACAGAATTA-1	Surrounding tumor	Tumor_edge_6
AGTTCCTATTTATGTT-1	Healthy	Healthy_2
AGTTCTGCGTTGTATC-1	Invasive	IDC_5
AGTTGACATCGGCTGG-1	Invasive	IDC_5
AGTTGACGGTCCTTGC-1	Tumor	DCIS/LCIS_4
AGTTGCGGTCCTCAAC-1	Invasive	IDC_4
AGTTGCTGACTGATAT-1	Invasive	IDC_5
AGTTGGCAAGGCTAGA-1	Invasive	IDC_2
AGTTTATGTAAAGACA-1	Healthy	Healthy_1
AGTTTCGCAGGTCGGA-1	Surrounding tumor	Tumor_edge_6
AGTTTGCACCTGCCTC-1	Tumor	DCIS/LCIS_4
AGTTTGGCACGGGTTG-1	Surrounding tumor	Tumor_edge_3
AGTTTGGCCAGACCTA-1	Tumor	DCIS/LCIS_3
ATAAACGGACCCGTAA-1	Healthy	Healthy_2
ATAAACGTTGCACCAC-1	Tumor	DCIS/LCIS_2
ATAAAGGCTCGGTCGT-1	Tumor	DCIS/LCIS_3
ATAAAGGTCAAGTACG-1	Surrounding tumor	Tumor_edge_1
ATAAATATTAGCAGCT-1	Tumor	DCIS/LCIS_3
ATAACGCCGGAGGGTC-1	Invasive	IDC_6
ATAACGGAGTCCAACG-1	Invasive	IDC_7
ATAACGTTACCTCCAC-1	Healthy	Healthy_1
ATAAGGTGGAGAACAT-1	Healthy	Healthy_2
ATAAGTACCCGATTGT-1	Healthy	Healthy_1
ATAAGTAGGATTCAGA-1	Surrounding tumor	Tumor_edge_6
ATAAGTAGGGCGACTC-1	Tumor	DCIS/LCIS_1
ATAAGTTACCGCGACG-1	Tumor	DCIS/LCIS_3
ATAATACCGTTAGCCG-1	Invasive	IDC_5
ATAATAGCTGTTGAAT-1	Healthy	Healthy_2
ATAATAGTGTAGGGAC-1	Invasive	IDC_5
ATAATCTTGGAGAACC-1	Tumor	DCIS/LCIS_4
ATAATTAGCTAAGTAG-1	Tumor	DCIS/LCIS_4
ATACAGGCCCTCCAAT-1	Tumor	DCIS/LCIS_4
ATACCACGGGCAACTT-1	Tumor	DCIS/LCIS_3
ATACCAGCAAATTGCT-1	Tumor	DCIS/LCIS_5
ATACCAGGCTAATAGA-1	Invasive	IDC_5
ATACCAGGTGAGCGAT-1	Tumor	DCIS/LCIS_5
ATACCGTCATCCATAA-1	Healthy	Healthy_1
ATACCTAACCAAGAAA-1	Tumor	DCIS/LCIS_4
ATACGCCGGCGAAACC-1	Invasive	IDC_6
ATACGGAACGTCGTTT-1	Invasive	IDC_4
ATACGGGTTTCGATTG-1	Surrounding tumor	Tumor_edge_1
ATACGTACTTAGCCAC-1	Tumor	DCIS/LCIS_4
ATACGTCCACTCCTGT-1	Surrounding tumor	Tumor_edge_5
ATACGTTATGCACGGA-1	Tumor	DCIS/LCIS_4
ATACTACCCGTACCAC-1	Surrounding tumor	Tumor_edge_4
ATACTAGCATGACCCT-1	Invasive	IDC_5
ATACTCTCGCCACTCT-1	Invasive	IDC_5
ATACTGCCTTACACCG-1	Tumor	DCIS/LCIS_4
ATAGACAACGGGACCT-1	Healthy	Healthy_1
ATAGACGAAGAGAAAG-1	Tumor	DCIS/LCIS_3
ATAGAGTACTGGGACA-1	Invasive	IDC_6
ATAGAGTTATCAACTT-1	Healthy	Healthy_1
ATAGATTTGCAGTCGG-1	Tumor	DCIS/LCIS_5
ATAGCAACTAGGGAAG-1	Invasive	IDC_2
ATAGCCATAACAGTCA-1	Invasive	IDC_2
ATAGCCTCAGTACCCA-1	Invasive	IDC_5
ATAGGAATCTAAGCTT-1	Surrounding tumor	Tumor_edge_6
ATAGGCGGCTATAGAA-1	Tumor	DCIS/LCIS_3
ATAGGCTAGCTTCGCA-1	Healthy	Healthy_1
ATAGGGATATCCTTGA-1	Invasive	IDC_7
ATAGGTTGGGCAGATG-1	Invasive	IDC_7
ATAGTCTTTGACGTGC-1	Tumor	DCIS/LCIS_5
ATAGTGAAGCGTTCTC-1	Tumor	DCIS/LCIS_3
ATAGTTCCACCCACTC-1	Tumor	DCIS/LCIS_1
ATATAAAGCGCTCGTG-1	Tumor	DCIS/LCIS_4
ATATAAATGTAGCTGC-1	Tumor	DCIS/LCIS_4
ATATAACACGGGCGCA-1	Invasive	IDC_2
ATATACGCTCGTGACG-1	Surrounding tumor	Tumor_edge_6
ATATAGAGTATTGGTC-1	Invasive	IDC_4
ATATCAACCTACAGAG-1	Tumor	DCIS/LCIS_1
ATATCGGTAGGGAGAT-1	Tumor	DCIS/LCIS_1
ATATCGTGCCAGACCC-1	Tumor	DCIS/LCIS_5
ATATCGTTCCTCGAAC-1	Invasive	IDC_2
ATATCTCCCTCGTTAA-1	Surrounding tumor	Tumor_edge_1
ATATCTTAGGGCCTTC-1	Invasive	IDC_6
ATATGGGATAGCAACT-1	Invasive	IDC_4
ATATGTCTAGAGCGTG-1	Invasive	IDC_4
ATATGTCTCCCTAGCC-1	Surrounding tumor	Tumor_edge_3
ATATGTGCACAAACCA-1	Healthy	Healthy_1
ATATTCAGTTAAACCT-1	Tumor	DCIS/LCIS_3
ATATTCCACATAGTGA-1	Surrounding tumor	Tumor_edge_5
ATATTCCCACAGGTCA-1	Invasive	IDC_5
ATATTGCTGTCAAAGT-1	Invasive	IDC_5
ATATTTAACCCTCAAG-1	Invasive	IDC_6
ATCAAACACTGTTCCA-1	Surrounding tumor	Tumor_edge_3
ATCAAACGAAGGTTTG-1	Surrounding tumor	Tumor_edge_2
ATCAAGATCCCAGGAC-1	Invasive	IDC_4
ATCAATCTGGGCTGCA-1	Invasive	IDC_6
ATCAATGCCGTGGCTG-1	Invasive	IDC_4
ATCACATTAGAATATC-1	Surrounding tumor	Tumor_edge_1
ATCACGTGCTAATTAA-1	Tumor	DCIS/LCIS_3
ATCACTTCATCCTCGC-1	Invasive	IDC_7
ATCAGACGGCACGCCG-1	Tumor	DCIS/LCIS_3
ATCAGCCTCATGCTGC-1	Invasive	IDC_2
ATCAGCTCGTCCACTA-1	Invasive	IDC_3
ATCAGGTCGCCATTGC-1	Healthy	Healthy_1
ATCAGTAGGCAGGGAT-1	Surrounding tumor	Tumor_edge_1
ATCATAGCCCTATGTA-1	Invasive	IDC_2
ATCATCCAATATTTGT-1	Tumor	DCIS/LCIS_3
ATCATCTGCCCAGTGT-1	Surrounding tumor	Tumor_edge_1
ATCCAACGCAGTCATA-1	Invasive	IDC_6
ATCCAATGGAGGGTCC-1	Tumor	DCIS/LCIS_3
ATCCACATCGACAGAA-1	Tumor	DCIS/LCIS_4
ATCCACGCTAAATGTT-1	Surrounding tumor	Tumor_edge_1
ATCCACTTTCAGACTA-1	Healthy	Healthy_1
ATCCAGGATTCGTGAA-1	Tumor	DCIS/LCIS_3
ATCCCATCCACAGCGC-1	Invasive	IDC_4
ATCCCATTTCCGTGGG-1	Invasive	IDC_4
ATCCTACCTAAGCTCT-1	Tumor	DCIS/LCIS_3
ATCCTGAATCGCTGCG-1	Tumor	DCIS/LCIS_3
ATCCTGCGTGGAATGG-1	Tumor	DCIS/LCIS_3
ATCCTGCTGCAGATAG-1	Surrounding tumor	Tumor_edge_1
ATCGACCCAATACAGA-1	Tumor	DCIS/LCIS_3
ATCGACTCTTTCCGTT-1	Invasive	IDC_7
ATCGCACGATTGTTCA-1	Invasive	IDC_5
ATCGCACGCCGGGAGA-1	Invasive	IDC_7
ATCGCCAGTCAACATT-1	Tumor	DCIS/LCIS_1
ATCGCTGCGTGCAGCA-1	Healthy	Healthy_1
ATCGGAGACAGACGGC-1	Tumor	DCIS/LCIS_4
ATCGGCAAGCAGTCCA-1	Healthy	Healthy_1
ATCGTCCAATCGAGTC-1	Invasive	IDC_5
ATCGTGGAAAGTCTGG-1	Invasive	IDC_4
ATCGTTAGCTAGCGGA-1	Invasive	IDC_2
ATCGTTCACTTTCGCC-1	Healthy	Healthy_1
ATCTAATATCCTACGG-1	Tumor	DCIS/LCIS_4
ATCTACCATCTGCTCC-1	Invasive	IDC_2
ATCTAGCTTGTGAGGG-1	Surrounding tumor	Tumor_edge_6
ATCTCCCACGGAATAT-1	Surrounding tumor	Tumor_edge_4
ATCTCCCTGCAATCTA-1	Surrounding tumor	Tumor_edge_1
ATCTCGTGAGCGAAAC-1	Surrounding tumor	Tumor_edge_3
ATCTGACATGGAAGGA-1	Invasive	IDC_4
ATCTGCACCTCTGCGA-1	Surrounding tumor	Tumor_edge_3
ATCTGCTGTTATCGCC-1	Invasive	IDC_4
ATCTGGGCTGTTCTTG-1	Tumor	DCIS/LCIS_4
ATCTGGTTAAGACTGT-1	Invasive	IDC_7
ATCTGTAATTGTACCC-1	Invasive	IDC_5
ATCTTAGGGCATTAAT-1	Invasive	IDC_4
ATCTTATCGCACACCC-1	Invasive	IDC_2
ATCTTGACCTGCAACG-1	Invasive	IDC_6
ATCTTGACTTGTCCAA-1	Surrounding tumor	Tumor_edge_3
ATCTTTCGTATAACCA-1	Healthy	Healthy_1
ATGAAGCCAAGGAGCC-1	Invasive	IDC_5
ATGACGCCGGCTCTAA-1	Invasive	IDC_5
ATGACGCGTTCTATCC-1	Surrounding tumor	Tumor_edge_2
ATGACTATCAGCTGTG-1	Invasive	IDC_4
ATGACTATGCGACATT-1	Surrounding tumor	Tumor_edge_5
ATGAGGAGTGTTAATC-1	Surrounding tumor	Tumor_edge_6
ATGAGGGCAGCGGCTA-1	Surrounding tumor	Tumor_edge_3
ATGATCGGGAATAGAC-1	Invasive	IDC_5
ATGATGCAATGGTACA-1	Tumor	DCIS/LCIS_3
ATGCACGCGCTGTTCA-1	Invasive	IDC_4
ATGCACTACCGCATTG-1	Invasive	IDC_6
ATGCATGATCCAGGAT-1	Invasive	IDC_7
ATGCATTCCGTGATGG-1	Tumor	DCIS/LCIS_5
ATGCCAATCGCTCTGC-1	Healthy	Healthy_1
ATGCCATTTGCGACCA-1	Invasive	IDC_1
ATGCCGGTCTTGCATA-1	Invasive	IDC_7
ATGCCGGTTGATGGGA-1	Surrounding tumor	Tumor_edge_1
ATGCGACAATTGGTCC-1	Healthy	Healthy_1
ATGCGACAGTCCCATT-1	Invasive	IDC_6
ATGCGAGTCCCACCAC-1	Surrounding tumor	Tumor_edge_3
ATGCTCAGTGTTGCAT-1	Invasive	IDC_5
ATGCTCTGGCGCGGTA-1	Tumor	DCIS/LCIS_4
ATGCTTAGGAGTTGAT-1	Tumor	DCIS/LCIS_2
ATGGAACCTTTGCACA-1	Tumor	DCIS/LCIS_1
ATGGAGCAGGCCGTGA-1	Invasive	IDC_6
ATGGATCCGGCGTCCG-1	Surrounding tumor	Tumor_edge_1
ATGGATTGACCAAACG-1	Invasive	IDC_7
ATGGCAGCATTACGAT-1	Invasive	IDC_4
ATGGCTGGAAATGGCC-1	Healthy	Healthy_1
ATGGGAACGGAAGCGG-1	Healthy	Healthy_1
ATGGGACCTGCTGAAC-1	Invasive	IDC_4
ATGGGCCTCGGCCTCT-1	Surrounding tumor	Tumor_edge_5
ATGGGTGTATACCTCC-1	Invasive	IDC_4
ATGGTATTGGGAACCG-1	Invasive	IDC_4
ATGGTATTTACTGATT-1	Invasive	IDC_4
ATGGTCGCGTGGTTTC-1	Invasive	IDC_1
ATGGTGCTCAAAGCCA-1	Tumor	DCIS/LCIS_5
ATGGTTACGAAACATG-1	Healthy	Healthy_1
ATGTAAGGCTGCTCTT-1	Tumor	DCIS/LCIS_1
ATGTACATGCGGTGAG-1	Surrounding tumor	Tumor_edge_4
ATGTACGATGACGTCG-1	Surrounding tumor	Tumor_edge_6
ATGTAGCGCGCGTAGG-1	Invasive	IDC_2
ATGTGAAAGCCTAATG-1	Surrounding tumor	Tumor_edge_2
ATGTGCATCCGACGCA-1	Invasive	IDC_5
ATGTGTAGTTTAGTCA-1	Tumor	DCIS/LCIS_5
ATGTTACGAGCAATAC-1	Invasive	IDC_5
ATGTTGATTAGAGACT-1	Invasive	IDC_2
ATGTTGTAGTCTGTTT-1	Invasive	IDC_4
ATTAAACATGCGGACC-1	Tumor	DCIS/LCIS_3
ATTAATACTACGCGGG-1	Invasive	IDC_7
ATTAATGAACCAGTCG-1	Surrounding tumor	Tumor_edge_1
ATTAATTCGGTCACTC-1	Surrounding tumor	Tumor_edge_1
ATTACAACTACCGGCC-1	Surrounding tumor	Tumor_edge_1
ATTACATGTCAGTCTT-1	Surrounding tumor	Tumor_edge_3
ATTACCACACTGCCTG-1	Surrounding tumor	Tumor_edge_3
ATTACGACTCCACAGT-1	Healthy	Healthy_1
ATTACGCGCTGGCAGG-1	Tumor	DCIS/LCIS_3
ATTACTAGCCTCTTGC-1	Invasive	IDC_5
ATTACTTACTGGGCAT-1	Healthy	Healthy_1
ATTAGATTCCTCAGCA-1	Healthy	Healthy_1
ATTAGATTGATAGCGG-1	Invasive	IDC_5
ATTAGGCGATGCTTTC-1	Invasive	IDC_6
ATTATACTTTGCTCGT-1	Surrounding tumor	Tumor_edge_1
ATTATAGCTACTTTAC-1	Tumor	DCIS/LCIS_1
ATTATCGGAATGTACG-1	Invasive	IDC_4
ATTATCTCGACAGATC-1	Tumor	DCIS/LCIS_5
ATTATGAGACCCAATT-1	Invasive	IDC_4
ATTATGCCATAGGGAG-1	Invasive	IDC_5
ATTATTATGTCCGTCA-1	Invasive	IDC_4
ATTATTCAGAGTCACT-1	Invasive	IDC_2
ATTCAACCATTTAAGG-1	Surrounding tumor	Tumor_edge_4
ATTCACTGATGTTGGA-1	Tumor	DCIS/LCIS_4
ATTCAGGACCTATTTC-1	Healthy	Healthy_1
ATTCAGTAGCAGGGTC-1	Surrounding tumor	Tumor_edge_2
ATTCATATACTGTCCA-1	Surrounding tumor	Tumor_edge_6
ATTCATCGTTGAGGCA-1	Invasive	IDC_2
ATTCCCACATAAACAA-1	Surrounding tumor	Tumor_edge_2
ATTCCTAAGACGTGGA-1	Healthy	Healthy_1
ATTCCTCCGCCAGTGC-1	Invasive	IDC_5
ATTCCTTCCAGGCGGT-1	Invasive	IDC_5
ATTCGACGCCGGGCCT-1	Tumor	DCIS/LCIS_3
ATTCGCGCCTTGAGAG-1	Invasive	IDC_2
ATTCGTGCTATCTCTT-1	Tumor	DCIS/LCIS_1
ATTCGTTTATCGTATT-1	Invasive	IDC_2
ATTCTCGTCTCTTTAG-1	Invasive	IDC_5
ATTCTGAGTATGAACT-1	Surrounding tumor	Tumor_edge_1
ATTCTTCGTACTTATG-1	Surrounding tumor	Tumor_edge_1
ATTGAAGATCTTAGTG-1	Tumor	DCIS/LCIS_3
ATTGACCGGCGATGAC-1	Healthy	Healthy_1
ATTGACGTAACTCGGT-1	Tumor	DCIS/LCIS_5
ATTGATAGCAACGAGA-1	Invasive	IDC_5
ATTGATGAGTCCTAAC-1	Surrounding tumor	Tumor_edge_3
ATTGCCTATTAGACCG-1	Invasive	IDC_4
ATTGCCTTTATGTTTG-1	Invasive	IDC_2
ATTGCGATCAGTAACT-1	Surrounding tumor	Tumor_edge_5
ATTGCTGCTCCTCCAT-1	Tumor	DCIS/LCIS_3
ATTGGATTACAGCGTA-1	Surrounding tumor	Tumor_edge_4
ATTGGGAATATCTTGG-1	Invasive	IDC_5
ATTGGGAGTTCTGTAA-1	Healthy	Healthy_1
ATTGGTTGTGCATTAC-1	Invasive	IDC_2
ATTGTACAACTCGGCT-1	Tumor	DCIS/LCIS_1
ATTGTCGCAATACCTT-1	Surrounding tumor	Tumor_edge_1
ATTGTCTGTTTCATGT-1	Invasive	IDC_4
ATTGTGACTTCGCTGC-1	Healthy	Healthy_1
ATTTAACTCGTATTAC-1	Invasive	IDC_5
ATTTACAGTTTACTGG-1	Tumor	DCIS/LCIS_3
ATTTACTAAGTCCATT-1	Surrounding tumor	Tumor_edge_3
ATTTATACTGGTAAAG-1	Invasive	IDC_4
ATTTCATTATTTCGCG-1	Surrounding tumor	Tumor_edge_1
ATTTCCGGGTTCTGCG-1	Invasive	IDC_4
ATTTGCCTAGTTACGA-1	Tumor	DCIS/LCIS_5
ATTTGCGCGAGTAGCT-1	Surrounding tumor	Tumor_edge_6
ATTTGTCTTGGGAGCT-1	Invasive	IDC_1
ATTTGTTCCAGGGCTC-1	Invasive	IDC_7
CAAACCCTCCGGCGGG-1	Invasive	IDC_2
CAAACGAGTATCGCAG-1	Tumor	DCIS/LCIS_3
CAAACGGTCGCACTTT-1	Tumor	DCIS/LCIS_3
CAAACGTGGTCTTGCG-1	Tumor	DCIS/LCIS_5
CAAACTACGATAGAGA-1	Surrounding tumor	Tumor_edge_1
CAAACTATTGAGCTTC-1	Tumor	DCIS/LCIS_5
CAAACTCGCGACGCCG-1	Surrounding tumor	Tumor_edge_3
CAAAGATTATTGGGCC-1	Invasive	IDC_4
CAAAGGTTAAATTCAG-1	Healthy	Healthy_1
CAAATCTCTCACAAGG-1	Surrounding tumor	Tumor_edge_2
CAAATGCGGAGTGTTC-1	Tumor	DCIS/LCIS_5
CAAATGTCCTTCCGTG-1	Tumor	DCIS/LCIS_3
CAAATTGGATTATGCC-1	Healthy	Healthy_1
CAAATTGTCAGCAAGC-1	Surrounding tumor	Tumor_edge_1
CAACACATCTCCTGCC-1	Surrounding tumor	Tumor_edge_3
CAACAGTGCCAAACGG-1	Tumor	DCIS/LCIS_5
CAACCAGTGGCCTACC-1	Tumor	DCIS/LCIS_2
CAACCTACCGAGCAGT-1	Invasive	IDC_2
CAACCTGAACCTGCCA-1	Healthy	Healthy_1
CAACGACCCGTTTACA-1	Invasive	IDC_5
CAACGGTTCTTGATAC-1	Invasive	IDC_5
CAACGTGGTGGAGTCT-1	Surrounding tumor	Tumor_edge_4
CAACTATATCGAATGC-1	Surrounding tumor	Tumor_edge_1
CAACTCCAACGTTTAG-1	Surrounding tumor	Tumor_edge_1
CAACTCCGTAACTTGC-1	Healthy	Healthy_1
CAACTCCTTGATCCCG-1	Invasive	IDC_5
CAACTGAGGGTATGAC-1	Healthy	Healthy_1
CAACTGCTCATCCGAT-1	Tumor	DCIS/LCIS_4
CAACTTGTAGTGGGCA-1	Invasive	IDC_5
CAAGAAACCCTAAACT-1	Healthy	Healthy_1
CAAGATATTATAACGT-1	Invasive	IDC_1
CAAGCAACGTCGGAGT-1	Tumor	DCIS/LCIS_3
CAAGCACCAAATGCCT-1	Invasive	IDC_5
CAAGCGGCACATAATT-1	Tumor	DCIS/LCIS_4
CAAGGATCGCATGTTC-1	Invasive	IDC_6
CAAGGCCAGTGGTGCA-1	Invasive	IDC_2
CAAGGTCCTATAGGCT-1	Tumor	DCIS/LCIS_1
CAAGTAAGTGATAGAC-1	Invasive	IDC_4
CAAGTGAACTTTGGTT-1	Surrounding tumor	Tumor_edge_1
CAAGTGTGGTTGCAAA-1	Surrounding tumor	Tumor_edge_3
CAATAAACCTTGGCCC-1	Invasive	IDC_7
CAATACGAGAGTCTGA-1	Surrounding tumor	Tumor_edge_3
CAATACGCTCTGAGGC-1	Surrounding tumor	Tumor_edge_2
CAATATGTAGATTTAC-1	Healthy	Healthy_1
CAATATTGGACTAGTG-1	Invasive	IDC_5
CAATCCCTATACCAGC-1	Surrounding tumor	Tumor_edge_1
CAATCCTGCCGTGGAG-1	Invasive	IDC_5
CAATGACCCTTAATTT-1	Invasive	IDC_4
CAATGAGGTTCGACTA-1	Surrounding tumor	Tumor_edge_3
CAATGCGAGAAGTATC-1	Tumor	DCIS/LCIS_4
CAATGGAATCTACATA-1	Healthy	Healthy_1
CAATGGATCTCTACCA-1	Surrounding tumor	Tumor_edge_6
CAATGGTCGGCCTGGG-1	Surrounding tumor	Tumor_edge_6
CAATGTGCCAACCCTT-1	Tumor	DCIS/LCIS_1
CAATTAAGGGTGATGA-1	Invasive	IDC_7
CAATTTCGTATAAGGG-1	Invasive	IDC_6
CAATTTGACCGGGAAG-1	Invasive	IDC_5
CACAAACCGCAGAACT-1	Invasive	IDC_2
CACAAGAAAGATATTA-1	Healthy	Healthy_1
CACAAGCTAAGAAAGG-1	Invasive	IDC_4
CACAATGAGCTGCTAT-1	Tumor	DCIS/LCIS_3
CACACACGCTAACGAG-1	Surrounding tumor	Tumor_edge_4
CACACAGCTTGCGCTC-1	Surrounding tumor	Tumor_edge_3
CACACAGGGATAGATT-1	Surrounding tumor	Tumor_edge_2
CACACGCGCTGTCTTA-1	Healthy	Healthy_1
CACACGTTTCAATGGG-1	Healthy	Healthy_1
CACACTTGTATTGCGA-1	Healthy	Healthy_1
CACAGAGACGAGGACG-1	Invasive	IDC_4
CACAGCACCCACGGCA-1	Invasive	IDC_6
CACAGCTAGGGAGTGA-1	Invasive	IDC_5
CACAGGGCCATATAGT-1	Invasive	IDC_2
CACAGGGCCGTTGTCA-1	Tumor	DCIS/LCIS_4
CACAGTCCCGCTTCGC-1	Tumor	DCIS/LCIS_2
CACAGTTCGCTTCCCA-1	Surrounding tumor	Tumor_edge_6
CACATCGTGCACGCGC-1	Invasive	IDC_4
CACATCTCACCGACGA-1	Tumor	DCIS/LCIS_4
CACATGATTCAGCAAC-1	Invasive	IDC_6
CACATGTTTGGACATG-1	Invasive	IDC_5
CACATTCTTTCGATGG-1	Surrounding tumor	Tumor_edge_1
CACATTTCTTGTCAGA-1	Tumor	DCIS/LCIS_1
CACCAGTCAGCATGCA-1	Invasive	IDC_4
CACCATCGGAGGAGAC-1	Surrounding tumor	Tumor_edge_1
CACCATGATCGCAAAG-1	Healthy	Healthy_1
CACCCAAATCTTATGT-1	Tumor	DCIS/LCIS_1
CACCCACACGTCACCC-1	Invasive	IDC_5
CACCCACGAGGCAATT-1	Surrounding tumor	Tumor_edge_1
CACCCGCGTTTGACAC-1	Invasive	IDC_2
CACCCTAACAAGATCT-1	Tumor	DCIS/LCIS_4
CACCCTTGGTGAGACC-1	Invasive	IDC_3
CACCCTTTCCTCGCTC-1	Invasive	IDC_5
CACCGATACACCGAGC-1	Surrounding tumor	Tumor_edge_1
CACCGATGATGGGTAC-1	Invasive	IDC_2
CACCGCCAGAAGGTTT-1	Invasive	IDC_7
CACCGCCGACCAGCGA-1	Tumor	DCIS/LCIS_5
CACCGCGTCCACTCTA-1	Healthy	Healthy_1
CACCGGAGATATCTCC-1	Healthy	Healthy_1
CACCGGGCATCACAAG-1	Invasive	IDC_2
CACCGGTAGAGACATT-1	Invasive	IDC_4
CACCGTATCCCATCCG-1	Surrounding tumor	Tumor_edge_5
CACCGTTGCGCGATAT-1	Surrounding tumor	Tumor_edge_2
CACCTAATAGAGTCGT-1	Invasive	IDC_5
CACCTAATCAGTTTAC-1	Invasive	IDC_7
CACCTCGATGGTGGAC-1	Invasive	IDC_7
CACCTTGCGAAACTCG-1	Surrounding tumor	Tumor_edge_1
CACCTTGGCGCCTTTG-1	Tumor	DCIS/LCIS_1
CACGAAAGTTAGTCCC-1	Tumor	DCIS/LCIS_3
CACGACGTAATAGTAA-1	Healthy	Healthy_1
CACGATTGGTCGTTAA-1	Surrounding tumor	Tumor_edge_6
CACGCACAGCGCAGCT-1	Invasive	IDC_7
CACGCAGCGAGGCTTT-1	Tumor	DCIS/LCIS_3
CACGCGGAACTGTTGC-1	Tumor	DCIS/LCIS_1
CACGGACGTGGATGGC-1	Healthy	Healthy_1
CACGGCGCGCCAAAGG-1	Healthy	Healthy_1
CACGTCAATCAATGGA-1	Surrounding tumor	Tumor_edge_4
CACGTCGGCAACCTCT-1	Surrounding tumor	Tumor_edge_6
CACGTCTATGATGTGG-1	Healthy	Healthy_1
CACGTTCGTGCTCTAG-1	Invasive	IDC_6
CACGTTTCGTACACAC-1	Invasive	IDC_2
CACTAAAGTTGCCTAT-1	Tumor	DCIS/LCIS_3
CACTACGGGAGCTGCC-1	Surrounding tumor	Tumor_edge_4
CACTACTCAGTTCTGT-1	Tumor	DCIS/LCIS_5
CACTCAAGAGCTATGG-1	Tumor	DCIS/LCIS_3
CACTCAGCTCTTGAGG-1	Tumor	DCIS/LCIS_5
CACTCCTATGTAAGAT-1	Invasive	IDC_4
CACTCCTCTCGGTCGG-1	Surrounding tumor	Tumor_edge_1
CACTCGAGCTGAACAA-1	Healthy	Healthy_2
CACTCTCAAGCATCGA-1	Invasive	IDC_4
CACTCTTCTGCTAGCC-1	Surrounding tumor	Tumor_edge_6
CACTGACGATTGTGGA-1	Invasive	IDC_4
CACTGTCCAAGTGAGA-1	Invasive	IDC_5
CACTTAATCAGACGGA-1	Tumor	DCIS/LCIS_3
CACTTCGCCACAGGCT-1	Invasive	IDC_5
CACTTCGTCTTATCTC-1	Invasive	IDC_5
CAGAACTTAGCCCTCT-1	Invasive	IDC_2
CAGAATAACACACGGA-1	Surrounding tumor	Tumor_edge_6
CAGACCTGTAAGTGTT-1	Surrounding tumor	Tumor_edge_6
CAGAGCATGAGCTTGC-1	Invasive	IDC_7
CAGAGTGATTTAACGT-1	Tumor	DCIS/LCIS_5
CAGATAATGGGCGGGT-1	Invasive	IDC_2
CAGATACTAACATAGT-1	Invasive	IDC_6
CAGATATGAAGATGAC-1	Invasive	IDC_4
CAGATCATTTAAAGTC-1	Healthy	Healthy_1
CAGATCCTGGTTTGAA-1	Invasive	IDC_4
CAGCAGCCCGTTCCTT-1	Invasive	IDC_7
CAGCAGTCCAGACTAT-1	Surrounding tumor	Tumor_edge_5
CAGCAGTCTGTGCTGC-1	Tumor	DCIS/LCIS_4
CAGCCCTCACAGGCAG-1	Tumor	DCIS/LCIS_5
CAGCCGGGCCCTCTAT-1	Surrounding tumor	Tumor_edge_1
CAGCCTCCTGCAGAGG-1	Surrounding tumor	Tumor_edge_1
CAGCCTCTCCTCAAGA-1	Healthy	Healthy_1
CAGCTCACTGAGACAT-1	Invasive	IDC_6
CAGCTCGACAAGTTAA-1	Healthy	Healthy_1
CAGCTCGTGCTTGTGT-1	Invasive	IDC_5
CAGCTGGCGTAACCGT-1	Surrounding tumor	Tumor_edge_2
CAGCTTAGTAGGTAGC-1	Tumor	DCIS/LCIS_3
CAGGAAGACTTTATAT-1	Surrounding tumor	Tumor_edge_1
CAGGATATATCGTTGT-1	Tumor	DCIS/LCIS_3
CAGGCAGTCTTACCAG-1	Invasive	IDC_2
CAGGCCAGTACCACCT-1	Invasive	IDC_4
CAGGCCGTTTGGGTGT-1	Tumor	DCIS/LCIS_3
CAGGCGCACGGTGGTC-1	Invasive	IDC_4
CAGGCGCCATGCTAGG-1	Healthy	Healthy_2
CAGTAACTATTTATTG-1	Healthy	Healthy_1
CAGTAATCCCTCCCAG-1	Invasive	IDC_5
CAGTACATTCTCTAAA-1	Healthy	Healthy_1
CAGTACCAGTTTACGT-1	Invasive	IDC_3
CAGTAGCCCACGCGGT-1	Healthy	Healthy_1
CAGTAGCGAGGTAGTA-1	Invasive	IDC_5
CAGTCCAACGCCTTCT-1	Healthy	Healthy_1
CAGTCGAGGATGCAAT-1	Healthy	Healthy_1
CAGTCTCTCGGCTAAT-1	Invasive	IDC_5
CAGTCTGTATACTGGG-1	Invasive	IDC_6
CAGTGAATAAATGACT-1	Surrounding tumor	Tumor_edge_1
CAGTGGTTGCACATGA-1	Invasive	IDC_5
CAGTGTCCGCAGAATG-1	Invasive	IDC_5
CAGTGTCGGCTGGCCC-1	Invasive	IDC_2
CAGTGTTAATCTCTCA-1	Invasive	IDC_4
CAGTTCAAATTGACAC-1	Invasive	IDC_6
CAGTTCCGCGGGTCGA-1	Surrounding tumor	Tumor_edge_2
CAGTTCGAGGACCCGA-1	Invasive	IDC_4
CATAACGGACAGTCGT-1	Invasive	IDC_1
CATAAGAAGCTTGGCT-1	Tumor	DCIS/LCIS_4
CATAAGCTCTCCGTCT-1	Surrounding tumor	Tumor_edge_2
CATAATGAGCGGGCGA-1	Surrounding tumor	Tumor_edge_1
CATACAAAGCCGAACC-1	Invasive	IDC_5
CATACACGGTTCCCAC-1	Tumor	DCIS/LCIS_4
CATACCCGTACCCAGT-1	Tumor	DCIS/LCIS_3
CATACGAACTAGCTGG-1	Invasive	IDC_4
CATACGGCGTCTGGGC-1	Invasive	IDC_6
CATACGGGTGCATGAT-1	Invasive	IDC_5
CATACTATGTAATTGT-1	Tumor	DCIS/LCIS_3
CATACTTAGGCAATAC-1	Tumor	DCIS/LCIS_1
CATACTTCTTTCTCCG-1	Invasive	IDC_4
CATAGAGGAGATACTA-1	Invasive	IDC_2
CATAGCCGCCCGGGAT-1	Surrounding tumor	Tumor_edge_2
CATAGTACATTGAGAG-1	Surrounding tumor	Tumor_edge_1
CATAGTAGCATAGTAG-1	Invasive	IDC_5
CATAGTCAAATACATA-1	Invasive	IDC_2
CATAGTCCACAAGAAC-1	Tumor	DCIS/LCIS_3
CATATACTACTGATAA-1	Healthy	Healthy_1
CATATAGGTACAGTCA-1	Tumor	DCIS/LCIS_3
CATATGTCAGGCTACG-1	Surrounding tumor	Tumor_edge_2
CATATTATTTGCCCTA-1	Tumor	DCIS/LCIS_5
CATCAAACTGGCGCCC-1	Healthy	Healthy_1
CATCATCTACCCGGAC-1	Tumor	DCIS/LCIS_5
CATCATTACCCTGAGG-1	Invasive	IDC_2
CATCCAATATAGTTTG-1	Invasive	IDC_4
CATCCCGAGATTCATA-1	Invasive	IDC_2
CATCCGCAGGCCCGAA-1	Invasive	IDC_5
CATCCTCTCAAAGATC-1	Invasive	IDC_2
CATCGCCCGCGGCCAA-1	Invasive	IDC_5
CATCGGACGGGTTAAT-1	Tumor	DCIS/LCIS_3
CATCTACCCGAGAACG-1	Healthy	Healthy_1
CATCTATCCCGTGTCT-1	Healthy	Healthy_1
CATCTTACACCACCTC-1	Tumor	DCIS/LCIS_1
CATGAACCGACATTTG-1	Invasive	IDC_5
CATGAACCTCTTATCA-1	Tumor	DCIS/LCIS_5
CATGACTTCGCTGAAT-1	Tumor	DCIS/LCIS_1
CATGAGATGCACTCTC-1	Tumor	DCIS/LCIS_4
CATGATCGCTTTGAGA-1	Invasive	IDC_2
CATGATGCACAATTCT-1	Invasive	IDC_7
CATGATGGAAGTTAGC-1	Tumor	DCIS/LCIS_1
CATGCATGGAGACCCT-1	Tumor	DCIS/LCIS_5
CATGCCAACTCGCAAA-1	Surrounding tumor	Tumor_edge_2
CATGCGACCAGTTTAA-1	Healthy	Healthy_1
CATGCGTTAGACAGAA-1	Invasive	IDC_5
CATGCGTTGAGAGGAG-1	Invasive	IDC_4
CATGCTGGCTCCAATT-1	Invasive	IDC_5
CATGGAAATGGGACCA-1	Healthy	Healthy_1
CATGGATTGTCTTCCG-1	Surrounding tumor	Tumor_edge_6
CATGGCAGGAAGATCG-1	Invasive	IDC_5
CATGGGTATGCCTTAT-1	Tumor	DCIS/LCIS_4
CATGGGTCGGGTGTGG-1	Surrounding tumor	Tumor_edge_1
CATGGTCTAGATACCG-1	Invasive	IDC_7
CATGGTTTATTAATCA-1	Invasive	IDC_2
CATGTAAGAGACATTT-1	Invasive	IDC_2
CATGTAGGAGCGCCAA-1	Healthy	Healthy_1
CATGTCTCATTTATGG-1	Surrounding tumor	Tumor_edge_5
CATTACATAGATTGTG-1	Surrounding tumor	Tumor_edge_6
CATTACGCAGGAAGGG-1	Invasive	IDC_2
CATTACGTCGGCCCGT-1	Invasive	IDC_5
CATTATAACAGGGTCC-1	Tumor	DCIS/LCIS_5
CATTATCCCATTAACG-1	Invasive	IDC_4
CATTATGCTTGTTGTG-1	Invasive	IDC_6
CATTCACTGACAGCTA-1	Tumor	DCIS/LCIS_5
CATTCAGGTCAGTGCG-1	Invasive	IDC_5
CATTCCCATTCCGTCG-1	Surrounding tumor	Tumor_edge_3
CATTCCCTAAGTACAA-1	Invasive	IDC_5
CATTGATGAACACGCC-1	Healthy	Healthy_1
CATTGCGGGTCAATTC-1	Healthy	Healthy_1
CATTGTGTGCTAGATC-1	Invasive	IDC_5
CATTTAGCGGACCATG-1	Surrounding tumor	Tumor_edge_1
CATTTATCGTTCAAGA-1	Tumor	DCIS/LCIS_5
CATTTCTAGCAGACTA-1	Invasive	IDC_5
CCAAACAGAACCCTCG-1	Invasive	IDC_5
CCAAATAACAAGATTC-1	Surrounding tumor	Tumor_edge_5
CCAAATCAAAGGGCAA-1	Invasive	IDC_4
CCAACCTTATGTAACT-1	Invasive	IDC_4
CCAACGATGCACTGAT-1	Tumor	DCIS/LCIS_3
CCAACGCTTGCCAGGG-1	Healthy	Healthy_1
CCAAGACTTCTGCGAA-1	Invasive	IDC_5
CCAAGCGTAACTCGTA-1	Invasive	IDC_6
CCAAGGAACAGAGAGG-1	Invasive	IDC_5
CCAAGGTTGCCCTTTC-1	Invasive	IDC_2
CCAATAGTGCCGTCGA-1	Tumor	DCIS/LCIS_3
CCAATCGGTAGATCGA-1	Surrounding tumor	Tumor_edge_1
CCAATGTCACAGCAAG-1	Tumor	DCIS/LCIS_3
CCAATTACGGGTCGAG-1	Healthy	Healthy_1
CCAATTGAATGTTAAT-1	Invasive	IDC_5
CCACAATGTACGTCTT-1	Invasive	IDC_7
CCACACTGAGATATTA-1	Tumor	DCIS/LCIS_3
CCACAGCTGAAATCAT-1	Invasive	IDC_5
CCACAGTACCCATCCT-1	Surrounding tumor	Tumor_edge_5
CCACATACTGCACCCA-1	Surrounding tumor	Tumor_edge_3
CCACCCAAGGAAAGTG-1	Invasive	IDC_6
CCACGAATTTAACCTC-1	Tumor	DCIS/LCIS_1
CCACGAGAAGAGAATC-1	Surrounding tumor	Tumor_edge_1
CCACGGAGCCATAAGA-1	Surrounding tumor	Tumor_edge_2
CCACGGTGCCCGGTAG-1	Tumor	DCIS/LCIS_1
CCACTAAACTGAATCG-1	Invasive	IDC_5
CCACTATCCGGGTCAC-1	Surrounding tumor	Tumor_edge_3
CCACTCAGATCCGCAA-1	Invasive	IDC_2
CCACTGGTGGCTGGTT-1	Surrounding tumor	Tumor_edge_2
CCACTGTTTGGATTAA-1	Tumor	DCIS/LCIS_2
CCAGAAACTGATGCGA-1	Invasive	IDC_2
CCAGAGACAAAGCCGG-1	Surrounding tumor	Tumor_edge_2
CCAGATAGTTGAGTGA-1	Invasive	IDC_7
CCAGCCTGGACCAATA-1	Invasive	IDC_6
CCAGCTACGCCTCATA-1	Invasive	IDC_5
CCAGCTCGAACGCATT-1	Tumor	DCIS/LCIS_4
CCAGCTGATGGTACTT-1	Tumor	DCIS/LCIS_3
CCAGCTTCCGCCCGCA-1	Surrounding tumor	Tumor_edge_2
CCAGGGACGTGGCCTC-1	Invasive	IDC_6
CCAGTAGTCTGATCCA-1	Healthy	Healthy_1
CCAGTCCATTATTCGA-1	Invasive	IDC_5
CCAGTCTAGACGGCGC-1	Surrounding tumor	Tumor_edge_1
CCAGTCTTGTCATAGA-1	Tumor	DCIS/LCIS_4
CCAGTGTACAGACCGA-1	Invasive	IDC_4
CCAGTTCGGTAACTCA-1	Surrounding tumor	Tumor_edge_6
CCATAAACAACCCGAC-1	Surrounding tumor	Tumor_edge_1
CCATACCTTTACTTGT-1	Surrounding tumor	Tumor_edge_3
CCATAGGTTGGCGTGG-1	Invasive	IDC_5
CCATAGTCAGTAACCC-1	Invasive	IDC_5
CCATATGGAAACTATA-1	Surrounding tumor	Tumor_edge_5
CCATATTGGATCATGA-1	Invasive	IDC_5
CCATCCATACCAAGTC-1	Invasive	IDC_5
CCATCTCACCAGTGAA-1	Tumor	DCIS/LCIS_1
CCATCTTGTTCACAAT-1	Invasive	IDC_5
CCATGCCCTAGATTTC-1	Invasive	IDC_2
CCATGCCTGTTTAGTA-1	Tumor	DCIS/LCIS_3
CCATGCTCTGCAGGAA-1	Invasive	IDC_5
CCATGGCCCTTGTACC-1	Tumor	DCIS/LCIS_3
CCATGTTCATCTATAT-1	Invasive	IDC_4
CCATTAGCGATAATCC-1	Tumor	DCIS/LCIS_3
CCATTCCCTGCCCACA-1	Tumor	DCIS/LCIS_3
CCATTGTTTCCTCCAT-1	Surrounding tumor	Tumor_edge_3
CCATTTCTACCTATTA-1	Tumor	DCIS/LCIS_4
CCCAAACATGCTGCTC-1	Healthy	Healthy_1
CCCAACATACGTCGCG-1	Tumor	DCIS/LCIS_3
CCCAACCACACTAACA-1	Tumor	DCIS/LCIS_5
CCCAAGACAGAGTATG-1	Tumor	DCIS/LCIS_5
CCCAAGTCATTACACT-1	Invasive	IDC_2
CCCAATGAGATTTGCA-1	Invasive	IDC_4
CCCAATTTCACAACTT-1	Tumor	DCIS/LCIS_3
CCCAGAGGAGGGCGTA-1	Healthy	Healthy_1
CCCAGGAAGAATTCGA-1	Invasive	IDC_4
CCCAGGTCTGAAGGCT-1	Surrounding tumor	Tumor_edge_6
CCCAGTAAACTTGGGA-1	Invasive	IDC_3
CCCAGTTAAGGCGCCG-1	Invasive	IDC_1
CCCATATAGGTCGATT-1	Surrounding tumor	Tumor_edge_4
CCCGAAGTTTCGCGAA-1	Surrounding tumor	Tumor_edge_2
CCCGACCATAGTCCGC-1	Invasive	IDC_7
CCCGAGTTTCTCCGTA-1	Surrounding tumor	Tumor_edge_3
CCCGCAGCGCGAACTA-1	Healthy	Healthy_2
CCCGCAGGGCCCAAAG-1	Tumor	DCIS/LCIS_5
CCCGCCATGCTCCCGT-1	Invasive	IDC_5
CCCGCGCAATGCACCC-1	Invasive	IDC_5
CCCGGGTCGTTCAGGG-1	Tumor	DCIS/LCIS_4
CCCGGTGGAAGAACCT-1	Surrounding tumor	Tumor_edge_2
CCCGGTGTATCGGAAT-1	Invasive	IDC_3
CCCGTAAGTCTAGGCC-1	Tumor	DCIS/LCIS_3
CCCGTAGCTGGGAAGA-1	Invasive	IDC_4
CCCGTCAGCGTCTGAC-1	Invasive	IDC_5
CCCGTTTCGCAGATGT-1	Surrounding tumor	Tumor_edge_5
CCCTACCCACACCCAG-1	Surrounding tumor	Tumor_edge_6
CCCTACTTGAACAATG-1	Invasive	IDC_2
CCCTAGTGTCAGGTGT-1	Invasive	IDC_5
CCCTATGTAGAGCAGA-1	Invasive	IDC_4
CCCTCATTCTGGAATT-1	Invasive	IDC_5
CCCTCCTCGCTCGTAT-1	Surrounding tumor	Tumor_edge_6
CCCTCGATAATACACA-1	Invasive	IDC_4
CCCTCGGGAGCCTTGT-1	Tumor	DCIS/LCIS_5
CCCTGAAATGAGTTGA-1	Tumor	DCIS/LCIS_3
CCCTGACTAACAAATT-1	Surrounding tumor	Tumor_edge_2
CCCTGATGTAACTCGT-1	Invasive	IDC_5
CCCTGCCCAATCCGCT-1	Surrounding tumor	Tumor_edge_2
CCCTGCGCTACGCATA-1	Tumor	DCIS/LCIS_3
CCCTGGTATGGGCGGC-1	Tumor	DCIS/LCIS_5
CCCTTTAATGGAGTTC-1	Invasive	IDC_2
CCGAAAGTGGTGAGCA-1	Invasive	IDC_5
CCGAACACTGGGCCTC-1	Surrounding tumor	Tumor_edge_2
CCGAACCTTCCCGGCC-1	Healthy	Healthy_2
CCGAAGTATATTGTTC-1	Invasive	IDC_5
CCGACAAACACATGAG-1	Invasive	IDC_5
CCGACAAAGGGAGTGC-1	Tumor	DCIS/LCIS_3
CCGACAATAGGCCGCC-1	Tumor	DCIS/LCIS_2
CCGACGGGCATGAGGT-1	Surrounding tumor	Tumor_edge_6
CCGACGTAAACACAAC-1	Healthy	Healthy_1
CCGACTCGCATAGTCT-1	Tumor	DCIS/LCIS_5
CCGAGAAGTCGCATAA-1	Surrounding tumor	Tumor_edge_3
CCGAGCTGTGCTTGTC-1	Healthy	Healthy_1
CCGAGGGATGTTAGGC-1	Tumor	DCIS/LCIS_5
CCGATCTCAACCTTAT-1	Tumor	DCIS/LCIS_1
CCGATCTTAAGAGGCT-1	Healthy	Healthy_1
CCGATTCGAGGGACCC-1	Surrounding tumor	Tumor_edge_2
CCGCACAAAGACCAAC-1	Invasive	IDC_6
CCGCACGTGACCTCGG-1	Tumor	DCIS/LCIS_3
CCGCACTTGCAATGAC-1	Invasive	IDC_2
CCGCATGTGGTACGAT-1	Tumor	DCIS/LCIS_4
CCGCCACCACAATCCA-1	Tumor	DCIS/LCIS_5
CCGCCGGAACTTCTCG-1	Invasive	IDC_3
CCGCCGGTCAACACAC-1	Invasive	IDC_5
CCGCCGTTGAGGATAA-1	Surrounding tumor	Tumor_edge_3
CCGCCTGCGAATTGGT-1	Healthy	Healthy_1
CCGCGGGTACGAAGAA-1	Tumor	DCIS/LCIS_3
CCGCGTAGGTAAGGGC-1	Tumor	DCIS/LCIS_3
CCGCTATCAGCACCAG-1	Healthy	Healthy_2
CCGCTCCAGGGCGATC-1	Surrounding tumor	Tumor_edge_6
CCGCTCTTCCGAACTA-1	Invasive	IDC_2
CCGCTGGTGCCATTCA-1	Tumor	DCIS/LCIS_5
CCGCTTACCTCACTCT-1	Tumor	DCIS/LCIS_3
CCGCTTGCTGACATGG-1	Surrounding tumor	Tumor_edge_3
CCGGAAGTGCAATATG-1	Invasive	IDC_2
CCGGAATGGTTTCAGT-1	Invasive	IDC_5
CCGGAGCGTACTTTCT-1	Tumor	DCIS/LCIS_4
CCGGAGGTCTTATGGT-1	Healthy	Healthy_1
CCGGCACGACCGTTTC-1	Tumor	DCIS/LCIS_1
CCGGCGCATATTGGAT-1	Invasive	IDC_5
CCGGCGTGAGACTCTG-1	Invasive	IDC_3
CCGGGACCCGCAGAGA-1	Invasive	IDC_5
CCGGGCGGTCTCGTCA-1	Invasive	IDC_7
CCGGGCTAAGAATTTC-1	Invasive	IDC_4
CCGGGCTGCTCCATAC-1	Surrounding tumor	Tumor_edge_6
CCGGGTTCGAGGTTAC-1	Tumor	DCIS/LCIS_3
CCGGTAATGGCTAGTC-1	Tumor	DCIS/LCIS_1
CCGTAAGTTGGTCCCA-1	Invasive	IDC_6
CCGTACCCAAGCGCCA-1	Invasive	IDC_5
CCGTAGGAAATCCCTG-1	Invasive	IDC_2
CCGTAGGGTTGTTTAC-1	Invasive	IDC_2
CCGTATCTCGTCGTAG-1	Surrounding tumor	Tumor_edge_2
CCGTATTAGCGCAGTT-1	Healthy	Healthy_1
CCGTCAACCTCTGGCG-1	Invasive	IDC_4
CCGTGAGGCATTCATG-1	Tumor	DCIS/LCIS_1
CCGTGCCCATGACGGC-1	Invasive	IDC_5
CCGTGGAACGATCCAA-1	Healthy	Healthy_1
CCGTGTTAAATTCCAT-1	Tumor	DCIS/LCIS_3
CCGTTACGTTAGAACA-1	Surrounding tumor	Tumor_edge_1
CCGTTCCGAATCTCGG-1	Surrounding tumor	Tumor_edge_6
CCTAAACAGGGTCCGT-1	Tumor	DCIS/LCIS_5
CCTAAAGGCTGACGCT-1	Surrounding tumor	Tumor_edge_1
CCTAAATTAACGGTTC-1	Invasive	IDC_6
CCTAAATTGTATCCTA-1	Surrounding tumor	Tumor_edge_5
CCTAACCCAAACAAGT-1	Surrounding tumor	Tumor_edge_5
CCTAACTAAGGCTCTA-1	Healthy	Healthy_1
CCTACAAGTCCGGAAT-1	Healthy	Healthy_1
CCTACATTCACAGACG-1	Surrounding tumor	Tumor_edge_2
CCTACGGCTCAGTCGA-1	Invasive	IDC_5
CCTACTGCTTACACTT-1	Invasive	IDC_6
CCTAGGCGTAGCGATC-1	Invasive	IDC_1
CCTAGGTAAAGGTAGC-1	Invasive	IDC_3
CCTAGTTAGTCGCATG-1	Surrounding tumor	Tumor_edge_1
CCTATAATGAGTGCCC-1	Tumor	DCIS/LCIS_4
CCTATATCGTGTCACG-1	Invasive	IDC_4
CCTATATTTGTCCTGG-1	Invasive	IDC_4
CCTATCTATATCGGAA-1	Surrounding tumor	Tumor_edge_1
CCTATGAAGTGGTGCC-1	Tumor	DCIS/LCIS_1
CCTATGGCTCCTAGTG-1	Invasive	IDC_4
CCTATGGGTTACCGTC-1	Invasive	IDC_7
CCTATGGTCAAAGCTG-1	Invasive	IDC_2
CCTATGTCCACTCCAC-1	Invasive	IDC_2
CCTCACCAATCTTGAC-1	Invasive	IDC_5
CCTCACCTGAGGGAGC-1	Surrounding tumor	Tumor_edge_3
CCTCACCTTAGCATCG-1	Healthy	Healthy_1
CCTCATGCAGCTACGA-1	Invasive	IDC_5
CCTCCCGACAATCCCT-1	Tumor	DCIS/LCIS_5
CCTCCGACAATTCAAG-1	Tumor	DCIS/LCIS_3
CCTCCTAGCTAGAGTC-1	Invasive	IDC_4
CCTCCTGTTGTGTCGT-1	Invasive	IDC_2
CCTCGAAGTGGACGGG-1	Surrounding tumor	Tumor_edge_1
CCTCGACCCACTGCCT-1	Tumor	DCIS/LCIS_5
CCTCGCCAGCAAATTA-1	Surrounding tumor	Tumor_edge_1
CCTCGCGCGATATAGG-1	Healthy	Healthy_1
CCTCGCGCTGTGCGAT-1	Tumor	DCIS/LCIS_4
CCTCGGACCGGGATAG-1	Invasive	IDC_1
CCTCGGTTTCCTTGCC-1	Invasive	IDC_4
CCTCGTTACGCCTGTT-1	Healthy	Healthy_1
CCTCTAATCTGCCAAG-1	Invasive	IDC_7
CCTCTACAAGGATTGG-1	Invasive	IDC_4
CCTCTATCGATTAGCA-1	Surrounding tumor	Tumor_edge_2
CCTCTCTCCCATCTAG-1	Tumor	DCIS/LCIS_3
CCTCTGGCCTAGACGG-1	Surrounding tumor	Tumor_edge_1
CCTCTGTACTATTCTA-1	Healthy	Healthy_2
CCTGAATATTTACATA-1	Invasive	IDC_7
CCTGACCACCGATGGT-1	Tumor	DCIS/LCIS_3
CCTGACGCAACCTTTA-1	Surrounding tumor	Tumor_edge_1
CCTGAGAATAAATGCA-1	Invasive	IDC_4
CCTGCGATAGAACTGT-1	Invasive	IDC_5
CCTGCTATTTGAGAAG-1	Invasive	IDC_6
CCTGGAAACGTTCTGC-1	Tumor	DCIS/LCIS_1
CCTGGCTAGACCCGCC-1	Surrounding tumor	Tumor_edge_6
CCTGGTCGAATGTGGG-1	Tumor	DCIS/LCIS_4
CCTGTAAGACATGATA-1	Tumor	DCIS/LCIS_3
CCTGTACTCACGCCCA-1	Tumor	DCIS/LCIS_3
CCTGTCACCCGGGCTC-1	Invasive	IDC_7
CCTGTCCCTCACGTTA-1	Tumor	DCIS/LCIS_1
CCTGTCGCCCGTAAAT-1	Invasive	IDC_6
CCTGTCGTGTATGAAG-1	Invasive	IDC_4
CCTGTTCAACCTCGGG-1	Invasive	IDC_4
CCTGTTTGAAGACACG-1	Invasive	IDC_2
CCTTAAGTACGCAATT-1	Surrounding tumor	Tumor_edge_6
CCTTCAGTTAAAGTGA-1	Invasive	IDC_4
CCTTCCGCAACGCTGC-1	Invasive	IDC_4
CCTTCGTATAGAATCC-1	Invasive	IDC_4
CCTTCTCAGCGTTCCT-1	Surrounding tumor	Tumor_edge_2
CCTTCTTGATCCAGTG-1	Invasive	IDC_7
CCTTGACCACTTTATT-1	Tumor	DCIS/LCIS_2
CCTTGTGAACGTGGTT-1	Invasive	IDC_4
CCTTTCAATGAAGAAA-1	Healthy	Healthy_1
CGAAACATAGATGGCA-1	Tumor	DCIS/LCIS_5
CGAAACGCAATTCATG-1	Tumor	DCIS/LCIS_3
CGAACAGTATGGGCGT-1	Surrounding tumor	Tumor_edge_5
CGAACATAGTCAGAAA-1	Healthy	Healthy_1
CGAACCCGCATGCGTC-1	Tumor	DCIS/LCIS_3
CGAACCTCTTTCCTAG-1	Invasive	IDC_4
CGAACGCCCAGTGCCG-1	Surrounding tumor	Tumor_edge_1
CGAACGGCCGGACAAC-1	Invasive	IDC_3
CGAAGATCAGTTTCAT-1	Invasive	IDC_4
CGAAGCTATAAATTCA-1	Healthy	Healthy_1
CGAAGGGTTTCAGATT-1	Invasive	IDC_4
CGAAGTTGCTCTGTGT-1	Tumor	DCIS/LCIS_3
CGAATCTGCTCGACGC-1	Invasive	IDC_4
CGAATGAAGTCATTGC-1	Invasive	IDC_4
CGAATGACGCATAATG-1	Tumor	DCIS/LCIS_4
CGACAATTTGATCTAA-1	Surrounding tumor	Tumor_edge_3
CGACACCGCTTAAGGA-1	Healthy	Healthy_1
CGACACGCTCCGACAG-1	Surrounding tumor	Tumor_edge_3
CGACAGTTCGCGTTAT-1	Tumor	DCIS/LCIS_3
CGACATGCGATCTTCT-1	Tumor	DCIS/LCIS_5
CGACCCTTAACGCCGG-1	Invasive	IDC_3
CGACGCATCCGTACCT-1	Invasive	IDC_3
CGACTCAGGATGTTAT-1	Healthy	Healthy_1
CGACTCGGTACACGGT-1	Healthy	Healthy_1
CGACTTTGTATAGCCT-1	Tumor	DCIS/LCIS_1
CGAGACCCTAGAGTGT-1	Tumor	DCIS/LCIS_3
CGAGACTACTGCTGCT-1	Invasive	IDC_2
CGAGAGATGTGAACCT-1	Invasive	IDC_7
CGAGAGCTTTCACTAC-1	Invasive	IDC_2
CGAGAGGGTAGCCGCG-1	Tumor	DCIS/LCIS_2
CGAGATTTCGCTCGGG-1	Surrounding tumor	Tumor_edge_3
CGAGCACTTCAAGTTT-1	Surrounding tumor	Tumor_edge_6
CGAGCGTTGATCAGCC-1	Invasive	IDC_5
CGAGCTGGGCTTTAGG-1	Surrounding tumor	Tumor_edge_6
CGAGGAGCTTCCATAT-1	Healthy	Healthy_1
CGAGGATCGGGAACGA-1	Surrounding tumor	Tumor_edge_3
CGAGGCCAGGCATTGG-1	Invasive	IDC_5
CGAGGCTAAATATGGC-1	Invasive	IDC_7
CGAGGGACTGCGGTCG-1	Invasive	IDC_6
CGAGGGTATCCAGGTG-1	Tumor	DCIS/LCIS_4
CGAGTACTAAAGAGGA-1	Tumor	DCIS/LCIS_3
CGAGTGAAGGTACCAG-1	Invasive	IDC_4
CGAGTGCTATAGTTCG-1	Invasive	IDC_5
CGAGTTCTGTCCCACC-1	Surrounding tumor	Tumor_edge_1
CGAGTTTATCGGACTG-1	Invasive	IDC_1
CGATAATACTCAGGTT-1	Surrounding tumor	Tumor_edge_3
CGATACCTCGCGGACA-1	Tumor	DCIS/LCIS_3
CGATAGCGATACAGTG-1	Invasive	IDC_4
CGATAGTCGTACTGCA-1	Invasive	IDC_2
CGATATTAGCCGCAGG-1	Invasive	IDC_5
CGATCATTAGAGGCAC-1	Healthy	Healthy_1
CGATCCACCATTGTTG-1	Invasive	IDC_4
CGATCCGACCCAGTGC-1	Tumor	DCIS/LCIS_3
CGATCCTCGCAACATA-1	Invasive	IDC_4
CGATCGAGAAGCACCA-1	Invasive	IDC_4
CGATCTGTTGGAGGAC-1	Surrounding tumor	Tumor_edge_2
CGATGGACCCTACGCC-1	Healthy	Healthy_1
CGATGTTGTTATCTAC-1	Invasive	IDC_4
CGATTAAATATCTCCT-1	Tumor	DCIS/LCIS_4
CGATTCGCCTGGCTGC-1	Tumor	DCIS/LCIS_4
CGCAAACACGAGTTAC-1	Invasive	IDC_6
CGCAATTACTTTCGGT-1	Invasive	IDC_5
CGCAATTAGGGTAATA-1	Invasive	IDC_6
CGCAATTCTACAATAA-1	Surrounding tumor	Tumor_edge_2
CGCACATGTCCACTAC-1	Invasive	IDC_1
CGCACGTCTGTTTATG-1	Invasive	IDC_4
CGCACGTGCGCTATCA-1	Tumor	DCIS/LCIS_1
CGCAGAAACATTTGCG-1	Surrounding tumor	Tumor_edge_1
CGCAGATCTTCACCCG-1	Healthy	Healthy_1
CGCAGGCGATCCAAAC-1	Surrounding tumor	Tumor_edge_5
CGCAGTTCTATCTTTC-1	Invasive	IDC_2
CGCATCATGGCTTCAG-1	Surrounding tumor	Tumor_edge_1
CGCATCCATCAGCCAG-1	Surrounding tumor	Tumor_edge_3
CGCATGCCGAATGCGT-1	Invasive	IDC_2
CGCATGGTGCGATGCT-1	Invasive	IDC_6
CGCATTAGCTAATAGG-1	Surrounding tumor	Tumor_edge_6
CGCCAAGAAGCCGAGT-1	Surrounding tumor	Tumor_edge_2
CGCCACCCGCATTAAC-1	Invasive	IDC_5
CGCCATCCGATTATGA-1	Surrounding tumor	Tumor_edge_1
CGCCCAGCACGCCTAG-1	Surrounding tumor	Tumor_edge_6
CGCCCAGCGTTTCACG-1	Invasive	IDC_2
CGCCCGCTTCCGTACA-1	Surrounding tumor	Tumor_edge_1
CGCCCTAATTGTTCAA-1	Invasive	IDC_4
CGCCCTTGAAGGCTGA-1	Surrounding tumor	Tumor_edge_2
CGCCGCCCATGCCTGT-1	Invasive	IDC_1
CGCCGCGTTCTGAACG-1	Invasive	IDC_4
CGCCGTTCAGCATAGT-1	Surrounding tumor	Tumor_edge_4
CGCCTCCCTCCTCTAT-1	Healthy	Healthy_2
CGCCTGGCCTACGTAA-1	Tumor	DCIS/LCIS_3
CGCCTTTAGCATGCTC-1	Surrounding tumor	Tumor_edge_3
CGCGAAGTGGCATACT-1	Invasive	IDC_2
CGCGACCGCGACAGAT-1	Tumor	DCIS/LCIS_4
CGCGAGAGGGACTTGT-1	Healthy	Healthy_1
CGCGAGTCTGCCGGGT-1	Invasive	IDC_3
CGCGCAAATGTCCAGA-1	Invasive	IDC_4
CGCGCAAGGAACTACA-1	Invasive	IDC_5
CGCGCCCGACTTAATA-1	Surrounding tumor	Tumor_edge_1
CGCGGCAGTATTACGG-1	Invasive	IDC_5
CGCGGCTCAACTTGAA-1	Tumor	DCIS/LCIS_1
CGCGGGAATTAGGCAG-1	Invasive	IDC_7
CGCGGGAATTCCTTTC-1	Invasive	IDC_2
CGCGGTAAGTCTAGCT-1	Surrounding tumor	Tumor_edge_3
CGCGGTACGGTATACA-1	Surrounding tumor	Tumor_edge_6
CGCGGTCACAAACCAA-1	Healthy	Healthy_1
CGCGTACATTCTGGAA-1	Healthy	Healthy_1
CGCGTCATATTAAACC-1	Tumor	DCIS/LCIS_5
CGCGTTCATGAAATAC-1	Invasive	IDC_6
CGCTACGGGACATTTA-1	Tumor	DCIS/LCIS_3
CGCTAGAGACCGCTGC-1	Tumor	DCIS/LCIS_1
CGCTATACCGCCCACT-1	Invasive	IDC_5
CGCTATTCAATGTATG-1	Invasive	IDC_5
CGCTATTCTTAGGCTC-1	Tumor	DCIS/LCIS_3
CGCTCGACATAATGAT-1	Invasive	IDC_5
CGCTCTCCGTAGATTA-1	Tumor	DCIS/LCIS_3
CGCTGGTGACTACCCT-1	Surrounding tumor	Tumor_edge_3
CGCTGTGACGCCGCAC-1	Invasive	IDC_6
CGCTGTGTGGATGTTG-1	Invasive	IDC_4
CGCTTAGTATTGATAC-1	Invasive	IDC_4
CGCTTATTCCCGGTCG-1	Tumor	DCIS/LCIS_3
CGCTTCCACTGAAATC-1	Invasive	IDC_5
CGCTTCGGTCTAAGAC-1	Invasive	IDC_2
CGCTTGGACGGATAGA-1	Surrounding tumor	Tumor_edge_4
CGCTTTCATACCGGTG-1	Invasive	IDC_5
CGCTTTCCGCCAAGGT-1	Surrounding tumor	Tumor_edge_6
CGCTTTCTTGCATTCG-1	Invasive	IDC_7
CGGAAATTTCACATCC-1	Surrounding tumor	Tumor_edge_1
CGGAACGTAAACATAG-1	Tumor	DCIS/LCIS_3
CGGACCTTTACGTCCC-1	Invasive	IDC_2
CGGAGCAATTTAATCG-1	Surrounding tumor	Tumor_edge_6
CGGAGCATGGCGATCC-1	Invasive	IDC_6
CGGAGCTTATAACACC-1	Surrounding tumor	Tumor_edge_1
CGGAGTTTGAGAGACA-1	Tumor	DCIS/LCIS_3
CGGATAAGCGGACATG-1	Invasive	IDC_5
CGGATCCTCAAGGACT-1	Tumor	DCIS/LCIS_4
CGGATGAATGCTGTGA-1	Invasive	IDC_4
CGGCAAACATCGTGCG-1	Healthy	Healthy_2
CGGCAATAAGATCGCC-1	Surrounding tumor	Tumor_edge_4
CGGCACCGTTAGCGCC-1	Surrounding tumor	Tumor_edge_1
CGGCACTCAAGAAAGT-1	Invasive	IDC_5
CGGCAGGGTCGGGTTG-1	Healthy	Healthy_1
CGGCCACGCACAAAGT-1	Tumor	DCIS/LCIS_3
CGGCCAGAGCGACCAT-1	Invasive	IDC_4
CGGCCCAACCTGTAGT-1	Surrounding tumor	Tumor_edge_3
CGGCCCAGGTATATCC-1	Tumor	DCIS/LCIS_1
CGGCGCCATCAATCCC-1	Invasive	IDC_2
CGGCTCTAAAGCTGCA-1	Surrounding tumor	Tumor_edge_3
CGGCTCTTCGTCGAAC-1	Surrounding tumor	Tumor_edge_1
CGGCTGCAAGATTAAG-1	Tumor	DCIS/LCIS_5
CGGCTTTGTATGATAA-1	Surrounding tumor	Tumor_edge_1
CGGGAACGCCCTGCAT-1	Invasive	IDC_4
CGGGAAGTACCGTGGC-1	Invasive	IDC_4
CGGGAATATAGTATAC-1	Surrounding tumor	Tumor_edge_3
CGGGAATTTATGTAAA-1	Healthy	Healthy_2
CGGGAGCTTCAGTGTA-1	Surrounding tumor	Tumor_edge_5
CGGGAGTATACCGCCG-1	Invasive	IDC_5
CGGGATCAATGTAAGA-1	Invasive	IDC_7
CGGGCAGCTAAACCGC-1	Invasive	IDC_6
CGGGCCATAGCCGCAC-1	Invasive	IDC_5
CGGGCCTTCTTTGTAA-1	Tumor	DCIS/LCIS_3
CGGGCGATGGATCACG-1	Invasive	IDC_2
CGGGTGTACCCATTTA-1	Invasive	IDC_7
CGGGTTCGGCACGTAT-1	Healthy	Healthy_1
CGGGTTTGTTAGGGCT-1	Surrounding tumor	Tumor_edge_6
CGGTAGAGGTGCAGGT-1	Healthy	Healthy_1
CGGTATAGGTATTAGC-1	Healthy	Healthy_1
CGGTATGGGCACTCTG-1	Invasive	IDC_4
CGGTCAAGTGGGAACC-1	Invasive	IDC_7
CGGTCCATGAGACTCC-1	Healthy	Healthy_1
CGGTCCGTCGCAAGCC-1	Invasive	IDC_4
CGGTCTATCAACCCGT-1	Surrounding tumor	Tumor_edge_1
CGGTGAAGACTAAAGT-1	Tumor	DCIS/LCIS_3
CGGTGCAGATAGAACG-1	Tumor	DCIS/LCIS_3
CGGTGCGCGTTGGTCC-1	Surrounding tumor	Tumor_edge_6
CGGTGGGCTCCAGCCT-1	Healthy	Healthy_1
CGGTGTACTTGATCCC-1	Invasive	IDC_5
CGGTTATCCAACAGTG-1	Healthy	Healthy_1
CGGTTCAAGTAGGTGT-1	Healthy	Healthy_1
CGGTTCCGGCTTCTTG-1	Invasive	IDC_5
CGGTTGACCTGGCATA-1	Tumor	DCIS/LCIS_3
CGGTTGAGTATCCTTC-1	Invasive	IDC_4
CGGTTGGGCAGGGTCC-1	Surrounding tumor	Tumor_edge_6
CGGTTGGGTTCAAGTT-1	Healthy	Healthy_1
CGGTTTATGAAGGAAC-1	Healthy	Healthy_1
CGTAAACGCTTGAGTG-1	Invasive	IDC_5
CGTAAAGCAAGAAATC-1	Invasive	IDC_4
CGTAACTTCGACACTT-1	Invasive	IDC_4
CGTACCGAAAGTCTAG-1	Invasive	IDC_5
CGTACCTGATAGGCCT-1	Invasive	IDC_7
CGTAGAGAGTAATTAT-1	Invasive	IDC_2
CGTAGCGAATTGTCAG-1	Surrounding tumor	Tumor_edge_1
CGTAGCGCCGACGTTG-1	Surrounding tumor	Tumor_edge_1
CGTATTAAGAGATCTA-1	Tumor	DCIS/LCIS_3
CGTCACGTCCATTGGT-1	Tumor	DCIS/LCIS_3
CGTCAGTGCGCACAAG-1	Invasive	IDC_5
CGTCAGTTTATCGTCT-1	Tumor	DCIS/LCIS_5
CGTCATACCATATCCA-1	Invasive	IDC_5
CGTCCTCATCGCGTGC-1	Invasive	IDC_2
CGTCGCATGTGAGCCA-1	Invasive	IDC_2
CGTCGCGGCGGGATTT-1	Invasive	IDC_5
CGTCGCTTGGTTATAC-1	Invasive	IDC_4
CGTCGGATAGTGTTGA-1	Surrounding tumor	Tumor_edge_6
CGTCGGGTCTAAGCGC-1	Surrounding tumor	Tumor_edge_6
CGTCGTCCTTCGCGAA-1	Tumor	DCIS/LCIS_4
CGTCTGGAAGGGCCCG-1	Invasive	IDC_5
CGTGAAGTTAATTCAC-1	Tumor	DCIS/LCIS_3
CGTGACATTGGGTCGT-1	Surrounding tumor	Tumor_edge_1
CGTGACCAGTCCTCTG-1	Tumor	DCIS/LCIS_4
CGTGCACACCACTGTA-1	Invasive	IDC_2
CGTGCAGACTGGGACA-1	Invasive	IDC_6
CGTGCATTGTCGACGC-1	Tumor	DCIS/LCIS_3
CGTGCCCGACATTTGT-1	Tumor	DCIS/LCIS_5
CGTGCTGGCCTAGTCG-1	Invasive	IDC_5
CGTGCTTCTACCTAAA-1	Invasive	IDC_4
CGTGGAAGCCTCGTAC-1	Surrounding tumor	Tumor_edge_3
CGTGGCCGAATATCTA-1	Surrounding tumor	Tumor_edge_3
CGTGGTACCCAAAGGC-1	Invasive	IDC_4
CGTGTATGGGAGCTGA-1	Invasive	IDC_2
CGTGTCCCATTCGCGA-1	Invasive	IDC_6
CGTGTCTCGTTACGAC-1	Invasive	IDC_4
CGTGTGTTAAACCCTG-1	Tumor	DCIS/LCIS_1
CGTTAAACTAGTTAGG-1	Surrounding tumor	Tumor_edge_3
CGTTAAATACGACCAG-1	Invasive	IDC_2
CGTTAATGTCCCGACG-1	Invasive	IDC_2
CGTTAGCTCACAACTG-1	Surrounding tumor	Tumor_edge_1
CGTTCAAGGAAACGGA-1	Invasive	IDC_4
CGTTCAGACCCGCGAA-1	Tumor	DCIS/LCIS_4
CGTTCATGGTGCGCGT-1	Invasive	IDC_3
CGTTCTTCGCACACCT-1	Healthy	Healthy_1
CGTTGAATACCGCGCT-1	Tumor	DCIS/LCIS_4
CGTTGAGTAATTGCGT-1	Healthy	Healthy_1
CGTTGCCCGCGTGGGA-1	Invasive	IDC_4
CGTTGTAAGATTGATT-1	Surrounding tumor	Tumor_edge_6
CGTTGTCGGCAATTGA-1	Tumor	DCIS/LCIS_4
CGTTGTTTCAATTCCC-1	Tumor	DCIS/LCIS_3
CGTTTAAGCGGAGCAC-1	Invasive	IDC_5
CGTTTACAAGGCAGCT-1	Healthy	Healthy_1
CGTTTCACTTCGGGCG-1	Healthy	Healthy_1
CGTTTCGCTCATTACA-1	Tumor	DCIS/LCIS_3
CGTTTCGGTTATATGC-1	Invasive	IDC_2
CTAAAGAATGCCTACT-1	Tumor	DCIS/LCIS_3
CTAAAGGGAAATAGGA-1	Tumor	DCIS/LCIS_3
CTAAAGTCCGAAGCTA-1	Invasive	IDC_5
CTAAATCCGGTGTACA-1	Invasive	IDC_4
CTAAATCCTATTCCGG-1	Surrounding tumor	Tumor_edge_1
CTAACCGCGCGCCCGT-1	Tumor	DCIS/LCIS_3
CTAACGAAACTTGCTG-1	Healthy	Healthy_1
CTAACTGATAATCGCC-1	Surrounding tumor	Tumor_edge_4
CTAACTGGTCCGGTTC-1	Surrounding tumor	Tumor_edge_2
CTAAGTACAGGGCTAC-1	Healthy	Healthy_1
CTAATTATGAAGCGTA-1	Healthy	Healthy_1
CTAATTCGCACGCGCT-1	Tumor	DCIS/LCIS_3
CTAATTCTCAGATATT-1	Surrounding tumor	Tumor_edge_3
CTAATTTCAACAACAC-1	Invasive	IDC_5
CTACAAGAAATAACCC-1	Invasive	IDC_4
CTACACTCGCAGATGG-1	Surrounding tumor	Tumor_edge_4
CTACATATCGCGGGAC-1	Invasive	IDC_4
CTACCCTAAGGTCATA-1	Healthy	Healthy_1
CTACGAACTAGGTCGA-1	Tumor	DCIS/LCIS_5
CTACGACTAGCTATAA-1	Tumor	DCIS/LCIS_3
CTACGATCCTATCCTA-1	Invasive	IDC_4
CTACGCACGGAGTACC-1	Tumor	DCIS/LCIS_3
CTACGCCATTTCCGAT-1	Surrounding tumor	Tumor_edge_1
CTACGTGTTGCCACCA-1	Invasive	IDC_5
CTACTATCATAGGTTT-1	Surrounding tumor	Tumor_edge_2
CTACTATCTTTCAGAG-1	Healthy	Healthy_1
CTACTCAAGGTATAGT-1	Invasive	IDC_4
CTACTCTAGGCCCGGC-1	Tumor	DCIS/LCIS_3
CTACTGCCACCTGACC-1	Invasive	IDC_7
CTAGACATATATGTAG-1	Healthy	Healthy_1
CTAGACTGCATTTCGT-1	Healthy	Healthy_1
CTAGATAAACTCCTCG-1	Invasive	IDC_5
CTAGATGTGAGTGTAA-1	Tumor	DCIS/LCIS_1
CTAGATTTACGACGGC-1	Healthy	Healthy_2
CTAGCATAGTATAATG-1	Invasive	IDC_6
CTAGCCACAGGCGAGC-1	Tumor	DCIS/LCIS_2
CTAGCCGATGTTATGA-1	Healthy	Healthy_1
CTAGGCGCCCTATCAG-1	Invasive	IDC_2
CTAGGCGGCAGAGAAT-1	Surrounding tumor	Tumor_edge_6
CTAGGGATAGGGACAA-1	Invasive	IDC_4
CTAGGTCTGAAGGAAT-1	Tumor	DCIS/LCIS_1
CTAGGTTCGGACGTGA-1	Tumor	DCIS/LCIS_4
CTAGTAGAAAGGGATT-1	Invasive	IDC_2
CTAGTATTCGGAATTA-1	Surrounding tumor	Tumor_edge_1
CTAGTCACGTCTTAAG-1	Invasive	IDC_6
CTAGTGAAGGACAGGA-1	Tumor	DCIS/LCIS_3
CTAGTTACAACCCGGT-1	Tumor	DCIS/LCIS_4
CTAGTTGGGCCCGGTA-1	Invasive	IDC_7
CTATAAGAGCCAATCG-1	Healthy	Healthy_1
CTATAGGCGTTGATGT-1	Invasive	IDC_4
CTATATCCAGCCTGGC-1	Invasive	IDC_4
CTATCACAACGCTGGA-1	Invasive	IDC_4
CTATCGACGAAATACA-1	Invasive	IDC_2
CTATCGCGTAGAGAAC-1	Surrounding tumor	Tumor_edge_4
CTATCGGGTCTCAACA-1	Invasive	IDC_6
CTATGCCCGAATGCAA-1	Tumor	DCIS/LCIS_4
CTATGGGAAGCGGAAT-1	Surrounding tumor	Tumor_edge_4
CTATGTCACTAGCCCA-1	Surrounding tumor	Tumor_edge_6
CTATGTCTATTGAAAC-1	Invasive	IDC_5
CTATGTGAGTCACGGC-1	Surrounding tumor	Tumor_edge_2
CTATTCATGTGTCCCA-1	Healthy	Healthy_2
CTATTGTGTTTGGTCA-1	Healthy	Healthy_1
CTATTTGCTTGGAGGA-1	Surrounding tumor	Tumor_edge_6
CTATTTGGTTACGGAT-1	Invasive	IDC_6
CTCAAACCACTGCCCG-1	Invasive	IDC_4
CTCAACTAACCCGGAT-1	Invasive	IDC_2
CTCAAGACATTAGCGC-1	Healthy	Healthy_1
CTCACACGCAAGCCTA-1	Healthy	Healthy_1
CTCACATTTACTAAAT-1	Tumor	DCIS/LCIS_4
CTCACCGATCCAAACT-1	Healthy	Healthy_1
CTCACTGTGATACTTA-1	Tumor	DCIS/LCIS_4
CTCACTTGGCTGGTAA-1	Tumor	DCIS/LCIS_3
CTCAGAGCTAATGTCG-1	Invasive	IDC_4
CTCAGGACTCACCTGT-1	Invasive	IDC_5
CTCAGTCACGACAAAT-1	Healthy	Healthy_1
CTCATAAATGTGTATA-1	Invasive	IDC_2
CTCATGGCTCACAATC-1	Surrounding tumor	Tumor_edge_6
CTCATGGTAATTTGCG-1	Surrounding tumor	Tumor_edge_2
CTCATTGCTCTAACAA-1	Tumor	DCIS/LCIS_4
CTCATTTGATGGGCGG-1	Surrounding tumor	Tumor_edge_6
CTCCCAATGAGTCGCG-1	Surrounding tumor	Tumor_edge_3
CTCCCTCCTTTCGATC-1	Invasive	IDC_3
CTCCGCCCACATGAGG-1	Tumor	DCIS/LCIS_3
CTCCGGCCTAATATGC-1	Invasive	IDC_5
CTCCGGCTTGTAGACA-1	Invasive	IDC_5
CTCCTAAGTTATGTCT-1	Invasive	IDC_5
CTCCTCCAGCTCACAC-1	Invasive	IDC_4
CTCCTGTTCAAGGCAG-1	Surrounding tumor	Tumor_edge_5
CTCCTTTACGCAAGTC-1	Healthy	Healthy_1
CTCGAATGGAACGTAT-1	Healthy	Healthy_1
CTCGAGATCCAAAGCA-1	Invasive	IDC_5
CTCGAGGTCGAACAGT-1	Invasive	IDC_6
CTCGATATTTGCGAGC-1	Healthy	Healthy_1
CTCGCACCTATATAGT-1	Invasive	IDC_7
CTCGCATTGCATAGCC-1	Invasive	IDC_4
CTCGCCGAATGTAGGG-1	Tumor	DCIS/LCIS_4
CTCGCTAGGTAAGCGA-1	Invasive	IDC_2
CTCGGGATAACACCTA-1	Surrounding tumor	Tumor_edge_3
CTCGGGCATCGTCGGG-1	Tumor	DCIS/LCIS_5
CTCGGGTTCTCTGGCC-1	Invasive	IDC_4
CTCGGTACCACTGCTC-1	Invasive	IDC_1
CTCGGTCCGTAGCCTG-1	Invasive	IDC_5
CTCGGTTGTCGGCCCT-1	Invasive	IDC_4
CTCGTCGAGGGCTCAT-1	Invasive	IDC_4
CTCGTCTGTGCCTTCG-1	Invasive	IDC_2
CTCGTTACGGCTACCA-1	Invasive	IDC_4
CTCGTTTCTAATGTTT-1	Healthy	Healthy_1
CTCTAATGCATTGATC-1	Healthy	Healthy_1
CTCTACACTGGCGATT-1	Surrounding tumor	Tumor_edge_2
CTCTACATCCTGCGTG-1	Invasive	IDC_4
CTCTAGCCCTCGGAAA-1	Invasive	IDC_2
CTCTATTTGGCTGCAG-1	Healthy	Healthy_2
CTCTCACAATCGATGA-1	Invasive	IDC_6
CTCTCGATGTGCGCCT-1	Tumor	DCIS/LCIS_5
CTCTCTAACTGCCTAG-1	Invasive	IDC_4
CTCTGCAGGCATTCTT-1	Invasive	IDC_4
CTCTGCGAAGCAAGCA-1	Invasive	IDC_5
CTCTGGACGCCTGGTG-1	Invasive	IDC_6
CTCTGTTTGAGGATTC-1	Surrounding tumor	Tumor_edge_1
CTCTTCTATTGACTGG-1	Tumor	DCIS/LCIS_1
CTCTTCTGGAAGTTAG-1	Invasive	IDC_4
CTCTTGTCCCGCTTGG-1	Healthy	Healthy_2
CTGAAACGGCCCTCAG-1	Surrounding tumor	Tumor_edge_6
CTGAAAGAGATCCGAC-1	Invasive	IDC_7
CTGAATCCGAGACCTC-1	Tumor	DCIS/LCIS_3
CTGAATTTATTGCCAG-1	Healthy	Healthy_1
CTGACATAGAAATAGA-1	Surrounding tumor	Tumor_edge_3
CTGACTGCGCAGCTCG-1	Surrounding tumor	Tumor_edge_3
CTGAGAAAGTTCGGCG-1	Surrounding tumor	Tumor_edge_3
CTGAGCAAGTAACAAG-1	Invasive	IDC_5
CTGCAAATGGGCTCCA-1	Tumor	DCIS/LCIS_5
CTGCAAGCACGTTCCG-1	Surrounding tumor	Tumor_edge_4
CTGCACAACTACATAT-1	Healthy	Healthy_2
CTGCACCTAGTCCACA-1	Surrounding tumor	Tumor_edge_3
CTGCACCTGGAACCGC-1	Invasive	IDC_5
CTGCACTCCAGTACAG-1	Tumor	DCIS/LCIS_4
CTGCAGAGAATCAGAG-1	Invasive	IDC_2
CTGCCAAGGTTGGAAG-1	Surrounding tumor	Tumor_edge_1
CTGCCATGCATCACAT-1	Tumor	DCIS/LCIS_3
CTGCCTAGCCACCAAG-1	Tumor	DCIS/LCIS_5
CTGCCTCATATGCAAC-1	Surrounding tumor	Tumor_edge_6
CTGCCTTTAATACCTT-1	Invasive	IDC_4
CTGCCTTTCTAGTAAA-1	Invasive	IDC_2
CTGCGACCTCGCCGAA-1	Invasive	IDC_2
CTGCGATTTCGAGATT-1	Invasive	IDC_4
CTGCGGGTGAAATGTT-1	Tumor	DCIS/LCIS_3
CTGCGGTAGTCACGTG-1	Healthy	Healthy_1
CTGCGTTACGATATAA-1	Surrounding tumor	Tumor_edge_1
CTGCTCTGACGGCAAA-1	Invasive	IDC_4
CTGCTGAGGCCACGAA-1	Surrounding tumor	Tumor_edge_2
CTGCTGTCTAACGAGC-1	Surrounding tumor	Tumor_edge_3
CTGCTTGGCGATAGCT-1	Tumor	DCIS/LCIS_4
CTGCTTTATGTCCGCG-1	Healthy	Healthy_1
CTGGAAATGGATGCTT-1	Invasive	IDC_6
CTGGAAGACACGGTGG-1	Surrounding tumor	Tumor_edge_5
CTGGACGCAGTCCGGC-1	Invasive	IDC_3
CTGGCATCCGAATGAG-1	Surrounding tumor	Tumor_edge_2
CTGGCGACATAAGTCC-1	Surrounding tumor	Tumor_edge_1
CTGGCGATTTACATGT-1	Invasive	IDC_2
CTGGCGCACAGGTCTG-1	Invasive	IDC_1
CTGGCGGGAATAAGTA-1	Invasive	IDC_5
CTGGCTCCTGCGGGAT-1	Invasive	IDC_5
CTGGCTGATTCATCCT-1	Surrounding tumor	Tumor_edge_3
CTGGCTGCTAACGTAA-1	Invasive	IDC_5
CTGGGATACGCTACCC-1	Tumor	DCIS/LCIS_1
CTGGGATCGCCCAGAT-1	Tumor	DCIS/LCIS_5
CTGGGCCTGCTATATC-1	Tumor	DCIS/LCIS_3
CTGGGCTACTGGAGAG-1	Invasive	IDC_2
CTGGGCTATCCTTTGG-1	Healthy	Healthy_1
CTGGGTTGAGTTAAAG-1	Invasive	IDC_3
CTGGTAAAGACTTACA-1	Invasive	IDC_2
CTGGTAAAGTGTGGGC-1	Tumor	DCIS/LCIS_2
CTGGTAACACATAGAA-1	Invasive	IDC_1
CTGGTAACGAGCTCTT-1	Healthy	Healthy_1
CTGGTCATTCCAATCC-1	Surrounding tumor	Tumor_edge_2
CTGGTCCTAACTTGGC-1	Tumor	DCIS/LCIS_5
CTGGTGAATGGGCCTA-1	Invasive	IDC_4
CTGGTTCAACGCATCA-1	Invasive	IDC_5
CTGGTTTCGAGCAAGA-1	Surrounding tumor	Tumor_edge_5
CTGTACTTCTTAGCAT-1	Tumor	DCIS/LCIS_3
CTGTAGTGAGGATCGA-1	Invasive	IDC_4
CTGTATGGTGTAGAAA-1	Invasive	IDC_5
CTGTCAAATGGCTCGG-1	Surrounding tumor	Tumor_edge_1
CTGTCACGCCAGGCGC-1	Healthy	Healthy_1
CTGTGCAGGGTAGGTC-1	Invasive	IDC_6
CTGTGGTCGGGAGATA-1	Invasive	IDC_2
CTGTTACCCAATCTAG-1	Healthy	Healthy_2
CTGTTCACTGCCTGTG-1	Invasive	IDC_5
CTGTTCATCTCACGGG-1	Invasive	IDC_5
CTGTTGTTCAGTCGTA-1	Invasive	IDC_4
CTTAACTTACAGTATA-1	Invasive	IDC_2
CTTAACTTCGAAGTAC-1	Surrounding tumor	Tumor_edge_1
CTTACACGGTATTCCA-1	Tumor	DCIS/LCIS_3
CTTACACTGGGAAATA-1	Invasive	IDC_5
CTTACATAGATTTCTT-1	Invasive	IDC_4
CTTAGATGTTTCATCC-1	Invasive	IDC_4
CTTAGCCTTCCACATG-1	Surrounding tumor	Tumor_edge_1
CTTAGGTATAGACCAG-1	Invasive	IDC_4
CTTAGTAGGCCTACAG-1	Surrounding tumor	Tumor_edge_3
CTTAGTGTAGTAGCAT-1	Surrounding tumor	Tumor_edge_6
CTTAGTTGAGGAATCG-1	Invasive	IDC_4
CTTATGCGCTCAGGGC-1	Surrounding tumor	Tumor_edge_2
CTTATGTTGACTACCA-1	Invasive	IDC_5
CTTCAACTCCACTTGG-1	Tumor	DCIS/LCIS_4
CTTCACGCCCTGGTAC-1	Invasive	IDC_4
CTTCAGTGGTCGCCTA-1	Surrounding tumor	Tumor_edge_6
CTTCAGTTGGACAACG-1	Invasive	IDC_2
CTTCATAGCTCAAGAA-1	Invasive	IDC_5
CTTCATTGTCAGTGGA-1	Tumor	DCIS/LCIS_3
CTTCGATTGCGCAAGC-1	Invasive	IDC_2
CTTCGGCCAATTGTTT-1	Surrounding tumor	Tumor_edge_3
CTTCGTAGATAGGTGA-1	Tumor	DCIS/LCIS_3
CTTCTATGTTGAAGTA-1	Surrounding tumor	Tumor_edge_2
CTTCTGGGCGTACCTA-1	Invasive	IDC_4
CTTCTTACGTCGTATA-1	Invasive	IDC_5
CTTGACCCGAAAGATA-1	Surrounding tumor	Tumor_edge_1
CTTGAGGTTATCCCGA-1	Invasive	IDC_5
CTTGAGTTAGGGTAAT-1	Invasive	IDC_1
CTTGATGACCATCCAG-1	Invasive	IDC_2
CTTGCAACCGCCTCCT-1	Surrounding tumor	Tumor_edge_2
CTTGCCCACCCACGCA-1	Invasive	IDC_2
CTTGCCCAGGCTCTAC-1	Tumor	DCIS/LCIS_3
CTTGGCCAAGCTGGGA-1	Tumor	DCIS/LCIS_4
CTTGTACTTGTTGACT-1	Invasive	IDC_5
CTTGTCAACATTCGAG-1	Healthy	Healthy_2
CTTGTGAGTCTTTGAC-1	Invasive	IDC_5
CTTGTGCTCACCGATT-1	Healthy	Healthy_1
CTTGTTGCTGAGTCAA-1	Invasive	IDC_6
CTTGTTTATGTAGCCA-1	Invasive	IDC_5
CTTTAACTTTCAAAGG-1	Invasive	IDC_7
CTTTAATATTGGTCGA-1	Healthy	Healthy_2
CTTTACCGAATAGTAG-1	Surrounding tumor	Tumor_edge_5
CTTTAGTGCTATTATT-1	Healthy	Healthy_2
CTTTCTGTGCGGGCTT-1	Tumor	DCIS/LCIS_4
CTTTGCATCGCTCTTG-1	Invasive	IDC_2
CTTTGGCAGACAGAGT-1	Healthy	Healthy_1
CTTTGGCGCTTTATAC-1	Surrounding tumor	Tumor_edge_2
CTTTGGCTTTAGTAAA-1	Tumor	DCIS/LCIS_3
CTTTGGGATTGTTGCA-1	Invasive	IDC_4
GAAACAGATGACCACC-1	Invasive	IDC_1
GAAACAGCCATGCAGT-1	Invasive	IDC_5
GAAACATAGGAAACAG-1	Invasive	IDC_4
GAAACCATGGTGCGCT-1	Surrounding tumor	Tumor_edge_3
GAAACCGAATTACCTT-1	Tumor	DCIS/LCIS_3
GAAACCTATACAAATG-1	Invasive	IDC_4
GAAACTCGTGCGATGC-1	Tumor	DCIS/LCIS_3
GAAACTCTAATGAAGG-1	Surrounding tumor	Tumor_edge_1
GAAAGAACAGCGTTAT-1	Tumor	DCIS/LCIS_1
GAAAGCAGTGCACTTT-1	Healthy	Healthy_2
GAAAGCCCTTTGGACC-1	Tumor	DCIS/LCIS_3
GAAAGTGACTAACTGC-1	Surrounding tumor	Tumor_edge_6
GAAATACCTGCTGGCT-1	Surrounding tumor	Tumor_edge_1
GAAATACTAAACGTTT-1	Invasive	IDC_5
GAAATATCACCATCAG-1	Tumor	DCIS/LCIS_3
GAAATATGCTTGAATG-1	Healthy	Healthy_1
GAAATCGCGCGCAACT-1	Invasive	IDC_7
GAAATGGCGGTGTTAG-1	Invasive	IDC_6
GAAATGGGATGTAAAC-1	Invasive	IDC_5
GAAATTAGCACGGATA-1	Healthy	Healthy_1
GAAATTCACATCGCTG-1	Invasive	IDC_5
GAAATTGTCTCTATAA-1	Tumor	DCIS/LCIS_3
GAACAACTGGGATGAA-1	Invasive	IDC_2
GAACACACATCAACCA-1	Invasive	IDC_5
GAACAGATTACTAAAT-1	Tumor	DCIS/LCIS_4
GAACATTAGTATGTTA-1	Healthy	Healthy_1
GAACCATCTGGGAGAC-1	Tumor	DCIS/LCIS_5
GAACCCTCTGTGTTCT-1	Tumor	DCIS/LCIS_4
GAACCTTTAACGATCC-1	Invasive	IDC_2
GAACGACCGAATGATA-1	Invasive	IDC_5
GAACGATAAGTTAAAG-1	Healthy	Healthy_1
GAACGCGGGTCACACG-1	Surrounding tumor	Tumor_edge_3
GAACGGTGTAAAGCAG-1	Healthy	Healthy_1
GAACGTCTCATGGTCG-1	Invasive	IDC_7
GAACTGTGGAGAGACA-1	Invasive	IDC_2
GAACTTAGCGCCCGGT-1	Surrounding tumor	Tumor_edge_6
GAAGAAACGATATTGT-1	Invasive	IDC_4
GAAGAACGGTGCAGGT-1	Invasive	IDC_5
GAAGACTTCAATGCCG-1	Tumor	DCIS/LCIS_5
GAAGCCACTGATTATG-1	Invasive	IDC_2
GAAGCCTGCACATTCC-1	Tumor	DCIS/LCIS_4
GAAGCGTGAGGAATTT-1	Invasive	IDC_6
GAAGCTCGGACCCGTC-1	Surrounding tumor	Tumor_edge_6
GAAGCTTGCTGACCGC-1	Tumor	DCIS/LCIS_3
GAAGGAGTCGAGTGCG-1	Surrounding tumor	Tumor_edge_6
GAAGGCTACCATTGTT-1	Healthy	Healthy_1
GAAGGGCATAACCATG-1	Surrounding tumor	Tumor_edge_6
GAAGGGTCATTAAGAC-1	Invasive	IDC_2
GAAGTCTCCCTAGCGA-1	Invasive	IDC_1
GAAGTGATTTATCGTG-1	Tumor	DCIS/LCIS_3
GAAGTGCTGGATAGCT-1	Invasive	IDC_5
GAAGTTTCCACTCAAT-1	Tumor	DCIS/LCIS_3
GAATAGACGCGACCCA-1	Invasive	IDC_1
GAATAGCATTTAGGGT-1	Surrounding tumor	Tumor_edge_3
GAATAGCCCTGCGGTC-1	Healthy	Healthy_1
GAATAGTGCTCGATTA-1	Invasive	IDC_4
GAATATTCGGAGTCCC-1	Surrounding tumor	Tumor_edge_1
GAATCGACATGGTCAC-1	Invasive	IDC_6
GAATCGCCGGACACGG-1	Invasive	IDC_5
GAATCTGAACATTCTC-1	Invasive	IDC_6
GAATGAAGGTCTTCAG-1	Healthy	Healthy_1
GAATGCCGAAATGACC-1	Invasive	IDC_5
GAATGCGAATCGGTTC-1	Tumor	DCIS/LCIS_4
GAATGTATGGCAGGTC-1	Surrounding tumor	Tumor_edge_1
GAATGTTGGGTAATCT-1	Invasive	IDC_7
GAATTATAGTGAAAGG-1	Invasive	IDC_6
GAATTCACCCGGGTGT-1	Tumor	DCIS/LCIS_3
GAATTTCTCGCTGCAG-1	Tumor	DCIS/LCIS_3
GACAAACATATGCAGG-1	Tumor	DCIS/LCIS_1
GACAACGACCATTGAA-1	Invasive	IDC_7
GACAACGCAGCTTACG-1	Invasive	IDC_5
GACAAGAGATGAGATT-1	Surrounding tumor	Tumor_edge_4
GACACAAGGGAAGAAA-1	Invasive	IDC_7
GACACAGCCGGGACTG-1	Invasive	IDC_2
GACACGAGTTAGAGGA-1	Invasive	IDC_5
GACACTGAGTTCAGTG-1	Tumor	DCIS/LCIS_3
GACACTGGAACCCGAT-1	Surrounding tumor	Tumor_edge_5
GACACTTCCAATTACC-1	Invasive	IDC_2
GACAGGCACACACTAT-1	Tumor	DCIS/LCIS_3
GACAGGTAATCCGTGT-1	Invasive	IDC_2
GACATCCGTCGAACTG-1	Invasive	IDC_2
GACATTTCGCCCAGCC-1	Invasive	IDC_4
GACCAAACGTTGACTG-1	Tumor	DCIS/LCIS_2
GACCACACTTCCCTTT-1	Invasive	IDC_2
GACCAGAGCCCTGTAG-1	Tumor	DCIS/LCIS_3
GACCAGGTCATTCATA-1	Tumor	DCIS/LCIS_5
GACCCAATTATGATAC-1	Invasive	IDC_4
GACCCGTCGCCGGCTA-1	Surrounding tumor	Tumor_edge_1
GACCGACGTGAAAGCA-1	Tumor	DCIS/LCIS_1
GACCGACTGAAGCGTC-1	Tumor	DCIS/LCIS_3
GACCGATTAAATATGT-1	Invasive	IDC_4
GACCGCGTCTGACGTG-1	Surrounding tumor	Tumor_edge_3
GACCGTCAGGTCGTGA-1	Surrounding tumor	Tumor_edge_1
GACCGTGCTGACGGTG-1	Tumor	DCIS/LCIS_3
GACCTTCCACGTCTAC-1	Invasive	IDC_2
GACGACGATCCGCGTT-1	Tumor	DCIS/LCIS_4
GACGAGGCTAATAAAC-1	Invasive	IDC_2
GACGATATCACTGGGT-1	Invasive	IDC_4
GACGCCTGTTGCAGGG-1	Invasive	IDC_5
GACGCTTGCTTCTAAA-1	Tumor	DCIS/LCIS_3
GACGGACCGCGTTCCT-1	Tumor	DCIS/LCIS_5
GACGGGCATCGAATTT-1	Invasive	IDC_2
GACGGGTTGGCCCGTA-1	Invasive	IDC_4
GACGGTCAATAGAAGC-1	Surrounding tumor	Tumor_edge_3
GACGTGAGACTCCATG-1	Invasive	IDC_5
GACGTGTAGGGATTAT-1	Tumor	DCIS/LCIS_3
GACGTTCGTAAATACA-1	Healthy	Healthy_1
GACTAACACAGCACCT-1	Surrounding tumor	Tumor_edge_6
GACTAAGATCATGCAC-1	Invasive	IDC_5
GACTAAGTAGGCTCAC-1	Invasive	IDC_6
GACTACAAAGCGGTGG-1	Invasive	IDC_3
GACTACAATTGCTCGT-1	Tumor	DCIS/LCIS_5
GACTAGGCCGTTAGGT-1	Invasive	IDC_2
GACTCACCCACGTGAG-1	Tumor	DCIS/LCIS_1
GACTCCCAGAATAAGG-1	Surrounding tumor	Tumor_edge_3
GACTCCTTCCAATTGA-1	Invasive	IDC_4
GACTCGCGGGAATGAC-1	Healthy	Healthy_1
GACTCGGTCGGCGGAT-1	Healthy	Healthy_1
GACTCTAGAGTTCCAA-1	Invasive	IDC_4
GACTGATTGGTCACAA-1	Healthy	Healthy_1
GACTGCAAATCGAGCT-1	Tumor	DCIS/LCIS_4
GACTGCGGCACGTGTA-1	Surrounding tumor	Tumor_edge_2
GACTGCTGGTGAGAAA-1	Invasive	IDC_4
GACTGGGCGCCGCAAC-1	Healthy	Healthy_1
GACTTCAACGCATCAA-1	Surrounding tumor	Tumor_edge_6
GAGAACGGTTCTGACT-1	Invasive	IDC_2
GAGACCCTGCAACGCC-1	Healthy	Healthy_1
GAGACTGATGGGTAGA-1	Invasive	IDC_6
GAGAGGCCTATGTGTA-1	Surrounding tumor	Tumor_edge_6
GAGAGGGCGCGAGGTT-1	Tumor	DCIS/LCIS_3
GAGAGGTGCATTCTGG-1	Tumor	DCIS/LCIS_3
GAGAGTCTCGGGAGAG-1	Invasive	IDC_4
GAGATCTGCTTGGCAT-1	Tumor	DCIS/LCIS_3
GAGATCTGTCACTCCG-1	Invasive	IDC_7
GAGATGACAATCCTTA-1	Healthy	Healthy_1
GAGATGGCTTTAATCA-1	Invasive	IDC_2
GAGATGGGAGTCGACA-1	Tumor	DCIS/LCIS_4
GAGCACCTGTGTCCAG-1	Tumor	DCIS/LCIS_4
GAGCATCAACAACTTG-1	Invasive	IDC_4
GAGCATCATCCCTGGG-1	Invasive	IDC_5
GAGCCACGGTAGTAGG-1	Invasive	IDC_5
GAGCCAGCTACCTGTG-1	Invasive	IDC_2
GAGCCGAGCGTTTATT-1	Healthy	Healthy_1
GAGCGAGGGAGTACCG-1	Invasive	IDC_5
GAGCGCAAATACTCCG-1	Surrounding tumor	Tumor_edge_5
GAGCGCGCACGAGTAG-1	Surrounding tumor	Tumor_edge_5
GAGCGCTGTTAGGTAA-1	Invasive	IDC_4
GAGCGGAATGCGGTGT-1	Invasive	IDC_4
GAGCTAAGGGCATATC-1	Invasive	IDC_7
GAGCTCAACATGAGCG-1	Invasive	IDC_4
GAGCTCTCGGACCTAA-1	Invasive	IDC_5
GAGCTGTCGTCTCGGA-1	Healthy	Healthy_1
GAGGAATATCTCTTTG-1	Invasive	IDC_4
GAGGAATGGAGAGGTT-1	Surrounding tumor	Tumor_edge_2
GAGGATAAACAGTGCT-1	Tumor	DCIS/LCIS_1
GAGGCATTTGCAGCAG-1	Healthy	Healthy_1
GAGGCCCGACTCCGCA-1	Invasive	IDC_4
GAGGCCTGTTGATACA-1	Invasive	IDC_2
GAGGCTATCAAAGTCG-1	Tumor	DCIS/LCIS_3
GAGGGAGTCAGATCGC-1	Invasive	IDC_4
GAGGGCATCGCGTATC-1	Invasive	IDC_5
GAGGGCCATAATATTA-1	Surrounding tumor	Tumor_edge_6
GAGGGCGCAGCTCTGC-1	Healthy	Healthy_1
GAGGGTAGTAACAAAG-1	Invasive	IDC_4
GAGGTACATCCATCTT-1	Surrounding tumor	Tumor_edge_1
GAGGTACGCGTGTCCC-1	Invasive	IDC_2
GAGGTCCCAAAGATCT-1	Invasive	IDC_5
GAGTAAACCGGAAAGT-1	Surrounding tumor	Tumor_edge_3
GAGTAAGGCCACGGGA-1	Invasive	IDC_3
GAGTACGGGTATACAA-1	Invasive	IDC_5
GAGTAGATACTAGTTG-1	Tumor	DCIS/LCIS_4
GAGTATGCGCGTGCAT-1	Tumor	DCIS/LCIS_4
GAGTCCGCTTACCGGA-1	Tumor	DCIS/LCIS_3
GAGTGTCAACCAGAAA-1	Invasive	IDC_2
GAGTGTGCGGTACCCA-1	Invasive	IDC_1
GAGTTGATGGCAATTT-1	Invasive	IDC_3
GAGTTGTCACCAGTCT-1	Invasive	IDC_4
GATAAATCGGTGGATG-1	Invasive	IDC_5
GATAACTCGCACTGTG-1	Invasive	IDC_1
GATAAGGCAGATGCAA-1	Invasive	IDC_5
GATACGATGGGAGTCA-1	Tumor	DCIS/LCIS_3
GATAGAACCCGCTAGG-1	Invasive	IDC_4
GATAGATAGTACAGTC-1	Invasive	IDC_2
GATAGGTAACGTTGAC-1	Healthy	Healthy_2
GATAGTGCGAGTAAGT-1	Invasive	IDC_4
GATATCTCATGCAATA-1	Invasive	IDC_5
GATATGAGACACTAAC-1	Surrounding tumor	Tumor_edge_6
GATATGCGGTAGCCAA-1	Surrounding tumor	Tumor_edge_1
GATATGGATTACGCGG-1	Surrounding tumor	Tumor_edge_2
GATATTGAGATTGGCG-1	Surrounding tumor	Tumor_edge_3
GATATTTCCTACATGG-1	Surrounding tumor	Tumor_edge_1
GATCAACATAAAGGGA-1	Invasive	IDC_4
GATCATTCCAAACATT-1	Invasive	IDC_6
GATCCCTTTATACTGC-1	Surrounding tumor	Tumor_edge_6
GATCCGGGAATTAACA-1	Invasive	IDC_6
GATCCTAAATCGGGAC-1	Healthy	Healthy_1
GATCCTCGACACTGGC-1	Surrounding tumor	Tumor_edge_2
GATCCTCTTGCGCTTA-1	Surrounding tumor	Tumor_edge_1
GATCGACACTATCTGA-1	Invasive	IDC_6
GATCGCGGGCTCTCCA-1	Tumor	DCIS/LCIS_3
GATCGCTACCCGATTT-1	Surrounding tumor	Tumor_edge_5
GATCGCTATATCTCAG-1	Invasive	IDC_4
GATCGCTGTGGTGCGT-1	Invasive	IDC_4
GATCGGATAGAACCAT-1	Surrounding tumor	Tumor_edge_2
GATCGGCGATAAGTCG-1	Invasive	IDC_5
GATCGGTGGCCATAAC-1	Invasive	IDC_7
GATCGTGACTGATATC-1	Invasive	IDC_6
GATCTCGACGCTGTGG-1	Surrounding tumor	Tumor_edge_3
GATCTGCTATCTAAGG-1	Tumor	DCIS/LCIS_4
GATCTTGGAGGGCATA-1	Healthy	Healthy_2
GATCTTTGCAGGGTAT-1	Tumor	DCIS/LCIS_3
GATCTTTGCTCAAAGA-1	Healthy	Healthy_1
GATGACAAGTAGGGCA-1	Invasive	IDC_4
GATGACGATGATCGCG-1	Healthy	Healthy_1
GATGAGGAACCTTCGG-1	Invasive	IDC_2
GATGCCAGCAGAAGGC-1	Surrounding tumor	Tumor_edge_2
GATGCCTTCTGCGGCA-1	Invasive	IDC_4
GATGCGTCCTGCATTC-1	Tumor	DCIS/LCIS_3
GATGCTACAAGCGCCT-1	Invasive	IDC_5
GATGCTACCTTCGATG-1	Invasive	IDC_4
GATGCTGTATTTCATC-1	Surrounding tumor	Tumor_edge_6
GATGGCGCACACATTA-1	Invasive	IDC_5
GATGGTGAAATAACCC-1	Healthy	Healthy_1
GATGGTGCCCTAGGCA-1	Tumor	DCIS/LCIS_5
GATGTAACGAACCACC-1	Invasive	IDC_3
GATGTCCGGATCACAT-1	Invasive	IDC_5
GATGTCGGTCAACTGC-1	Tumor	DCIS/LCIS_5
GATGTGTTGTCACAAG-1	Tumor	DCIS/LCIS_5
GATGTTCAATCCACGA-1	Tumor	DCIS/LCIS_3
GATGTTTGTGCGAGAT-1	Invasive	IDC_5
GATTAACCGAAAGCCC-1	Invasive	IDC_2
GATTAATCCTGGCTCA-1	Invasive	IDC_5
GATTACTGAATTTGGG-1	Tumor	DCIS/LCIS_3
GATTCCCTTGTCGCAG-1	Invasive	IDC_7
GATTCCGCGTTTCCGT-1	Surrounding tumor	Tumor_edge_1
GATTCCTATACGGCGC-1	Surrounding tumor	Tumor_edge_2
GATTCGACGGTTCACG-1	Invasive	IDC_6
GATTCTGTTAATGAGT-1	Invasive	IDC_4
GATTGACACTCTGCTC-1	Tumor	DCIS/LCIS_5
GATTGCTCCAGTTGCA-1	Invasive	IDC_4
GATTGGGAAAGGTTGT-1	Invasive	IDC_2
GCAAACCCTACATTAT-1	Healthy	Healthy_2
GCAAACCTTGGCCATA-1	Tumor	DCIS/LCIS_4
GCAAACGTCGCCAGGT-1	Surrounding tumor	Tumor_edge_3
GCAAAGGGCGTTAGCC-1	Invasive	IDC_4
GCAAATATTACGCTTT-1	Tumor	DCIS/LCIS_3
GCAACACACTAGAACT-1	Surrounding tumor	Tumor_edge_6
GCAACAGCAGTATGCG-1	Surrounding tumor	Tumor_edge_3
GCAACCACCAGACCGG-1	Healthy	Healthy_1
GCAACCACGGCCGCGT-1	Tumor	DCIS/LCIS_3
GCAACGGCTAGTTATG-1	Tumor	DCIS/LCIS_1
GCAAGAATTCCTTGGC-1	Tumor	DCIS/LCIS_3
GCAAGATGTGTTCGCG-1	Healthy	Healthy_1
GCAAGTGCACAGAGAA-1	Invasive	IDC_6
GCAAGTGTAAAGCATG-1	Invasive	IDC_4
GCAATTAGTCGCACCG-1	Surrounding tumor	Tumor_edge_3
GCACAAACCCTAGATG-1	Invasive	IDC_4
GCACAAACGAGGCGTG-1	Surrounding tumor	Tumor_edge_3
GCACAACCTCGGGCGT-1	Invasive	IDC_4
GCACAAGTGTCGGAAG-1	Tumor	DCIS/LCIS_5
GCACACACTGGTAGCC-1	Invasive	IDC_2
GCACACAGCTATTACC-1	Surrounding tumor	Tumor_edge_6
GCACAGCACGGGCCGA-1	Invasive	IDC_4
GCACCTAGGCGAGTCC-1	Invasive	IDC_2
GCACGCCGATTCCCGC-1	Invasive	IDC_2
GCACGTGGTTTACTTA-1	Invasive	IDC_2
GCACTAGTCGCGCTAT-1	Invasive	IDC_5
GCACTGCCTACCTTTA-1	Invasive	IDC_2
GCACTGTGCAAATGTA-1	Invasive	IDC_5
GCAGAAACGTAATCCA-1	Healthy	Healthy_1
GCAGACCCAGCACGTA-1	Tumor	DCIS/LCIS_1
GCAGATCCATAAGACT-1	Surrounding tumor	Tumor_edge_6
GCAGATTAGGGATATC-1	Tumor	DCIS/LCIS_3
GCAGCACACAGCCCAG-1	Tumor	DCIS/LCIS_3
GCAGCCTATATCACAT-1	Tumor	DCIS/LCIS_1
GCAGCGGTGGGCATTA-1	Invasive	IDC_5
GCAGCTATGGACAGGT-1	Healthy	Healthy_1
GCAGCTGTCAACGCAT-1	Invasive	IDC_2
GCAGGAACTTAGATCT-1	Invasive	IDC_3
GCAGGACTATAGAATA-1	Tumor	DCIS/LCIS_3
GCAGGTAGAGTATGGT-1	Healthy	Healthy_1
GCAGTGTGGCTATAGG-1	Tumor	DCIS/LCIS_4
GCAGTTCGATCCGAGC-1	Surrounding tumor	Tumor_edge_4
GCATACGAGGTCTTTA-1	Surrounding tumor	Tumor_edge_2
GCATAGAGCACTCAGG-1	Tumor	DCIS/LCIS_3
GCATCCCTAACTTTGA-1	Invasive	IDC_5
GCATCGGCCGTGTAGG-1	Surrounding tumor	Tumor_edge_3
GCATGAGGGACGCGGC-1	Healthy	Healthy_1
GCATGCTAATAACGAT-1	Invasive	IDC_2
GCATTCAAGGCAACGC-1	Surrounding tumor	Tumor_edge_3
GCATTCGAAATGAACA-1	Surrounding tumor	Tumor_edge_2
GCATTGTAATTCATAT-1	Surrounding tumor	Tumor_edge_2
GCATTTCCAAGGCTCC-1	Tumor	DCIS/LCIS_1
GCCAACCATTTCCGGA-1	Surrounding tumor	Tumor_edge_6
GCCAAGAATACTTCTG-1	Surrounding tumor	Tumor_edge_2
GCCAATAGGGCATCTC-1	Healthy	Healthy_1
GCCACAATTTAAGGAC-1	Tumor	DCIS/LCIS_3
GCCACTCAGAGCGCGA-1	Invasive	IDC_2
GCCACTCCTTACGGTA-1	Surrounding tumor	Tumor_edge_5
GCCAGGAAAGAACACT-1	Invasive	IDC_4
GCCAGGAGTAACCGAT-1	Surrounding tumor	Tumor_edge_1
GCCAGGCGTTCGCATG-1	Surrounding tumor	Tumor_edge_1
GCCATATTGCACACAG-1	Surrounding tumor	Tumor_edge_6
GCCATCGATGCTGCAT-1	Tumor	DCIS/LCIS_1
GCCATTAGCCTCAAAC-1	Invasive	IDC_3
GCCCACCAAGGCTGTC-1	Invasive	IDC_5
GCCCAGATGCTGGAGA-1	Tumor	DCIS/LCIS_1
GCCCAGTTGGTATGCC-1	Invasive	IDC_5
GCCCGACTTCTTCCCG-1	Surrounding tumor	Tumor_edge_2
GCCCGAGAGTCTAAAT-1	Invasive	IDC_4
GCCCGATCTGTGGTCG-1	Surrounding tumor	Tumor_edge_6
GCCCGCGCGTAAACGG-1	Surrounding tumor	Tumor_edge_6
GCCCGCGCGTTTGACA-1	Invasive	IDC_5
GCCCGTAATACCTTCT-1	Invasive	IDC_7
GCCCTAGCCGTCGCGA-1	Invasive	IDC_3
GCCCTGAGGATGGGCT-1	Invasive	IDC_2
GCCGAAATTCCTACGT-1	Tumor	DCIS/LCIS_3
GCCGACCCACGACTGC-1	Invasive	IDC_4
GCCGATTGGCCAAGCT-1	Tumor	DCIS/LCIS_3
GCCGCTTGTGAGAAAC-1	Tumor	DCIS/LCIS_3
GCCGGAAACACATCTT-1	Tumor	DCIS/LCIS_5
GCCGGGTTAGGGTCGC-1	Tumor	DCIS/LCIS_3
GCCGGTCGTATCTCTC-1	Invasive	IDC_4
GCCGTCGGTTTCGGGC-1	Invasive	IDC_4
GCCGTGGAAGAAATGT-1	Tumor	DCIS/LCIS_1
GCCTACGTTCTGTGCA-1	Invasive	IDC_2
GCCTAGCGATCTGACC-1	Invasive	IDC_5
GCCTATAGTGTCAGGG-1	Healthy	Healthy_1
GCCTATGCTGGGCCTT-1	Healthy	Healthy_1
GCCTATTCCGATATAG-1	Invasive	IDC_5
GCCTATTTGCTACACA-1	Invasive	IDC_5
GCCTCATCTGGAAATA-1	Surrounding tumor	Tumor_edge_3
GCCTCCGACAATTCAC-1	Invasive	IDC_2
GCCTCTATACATAGCA-1	Tumor	DCIS/LCIS_4
GCCTGCTACACTGAGA-1	Healthy	Healthy_1
GCCTGTCCCGGTGCAT-1	Invasive	IDC_4
GCCTTCAGCCCTACCG-1	Invasive	IDC_5
GCCTTGTATATGCAGT-1	Invasive	IDC_5
GCCTTTGTCAGTGGAC-1	Invasive	IDC_4
GCGAAACGATCGGGAG-1	Invasive	IDC_2
GCGAAGAATCTGACGG-1	Invasive	IDC_2
GCGAAGCCATACCCGT-1	Invasive	IDC_6
GCGAATGGACTAGCGA-1	Invasive	IDC_4
GCGACATGTAAACATC-1	Tumor	DCIS/LCIS_1
GCGACCCAACCATCTG-1	Invasive	IDC_4
GCGACGATAGTTGTAC-1	Tumor	DCIS/LCIS_3
GCGACGGTAGTCTCCT-1	Invasive	IDC_4
GCGAGAAACGGGAGTT-1	Invasive	IDC_5
GCGAGAGGCCATGTAA-1	Healthy	Healthy_1
GCGAGAGTTGCGTCCA-1	Tumor	DCIS/LCIS_1
GCGAGCGCATGCTCCC-1	Tumor	DCIS/LCIS_1
GCGAGGCCCGAGCAGA-1	Tumor	DCIS/LCIS_3
GCGAGTTCTGCAAAGA-1	Invasive	IDC_6
GCGATTCTGGAAGCAG-1	Tumor	DCIS/LCIS_5
GCGATTGTTAACGTTA-1	Invasive	IDC_6
GCGCAAATATATTCAA-1	Invasive	IDC_4
GCGCAAGAGCGCGCTG-1	Tumor	DCIS/LCIS_1
GCGCATCCAGTCAGCA-1	Healthy	Healthy_1
GCGCCGTTCCACGATA-1	Invasive	IDC_6
GCGCCTCCCACTCCGA-1	Surrounding tumor	Tumor_edge_3
GCGCGGTCTAGTAACT-1	Surrounding tumor	Tumor_edge_6
GCGCGTCATTGGTACA-1	Tumor	DCIS/LCIS_4
GCGCTAATTGAATAGA-1	Invasive	IDC_6
GCGCTATGCCGAGGCA-1	Tumor	DCIS/LCIS_3
GCGCTGATCCAGACTC-1	Surrounding tumor	Tumor_edge_1
GCGCTGCTTTGCATTT-1	Healthy	Healthy_1
GCGCTTAAATAATTGG-1	Invasive	IDC_2
GCGGAGAAACTTCGCA-1	Invasive	IDC_4
GCGGATTACTTGTTCT-1	Invasive	IDC_2
GCGGCAAAGTATTGCC-1	Invasive	IDC_4
GCGGCTCTGACGTACC-1	Tumor	DCIS/LCIS_3
GCGGCTTTAGCAAGTT-1	Invasive	IDC_2
GCGGGAACCAGGCCCT-1	Invasive	IDC_5
GCGGGCAGACGGGTGA-1	Invasive	IDC_4
GCGGGCATTACGATGC-1	Surrounding tumor	Tumor_edge_3
GCGGTAACCCAAATGA-1	Invasive	IDC_5
GCGGTCCCGGTGAAGG-1	Healthy	Healthy_1
GCGGTCCCTAGACGCA-1	Invasive	IDC_5
GCGGTCTTGCTTTCAC-1	Invasive	IDC_2
GCGGTGAACTGCGCTC-1	Healthy	Healthy_1
GCGGTTCCCTATCATG-1	Tumor	DCIS/LCIS_3
GCGTAAATGGCCATAA-1	Tumor	DCIS/LCIS_1
GCGTCCCTAAGACATA-1	Invasive	IDC_4
GCGTCGAAATGTCGGT-1	Invasive	IDC_5
GCGTCGCCAGGGTGAT-1	Tumor	DCIS/LCIS_4
GCGTCGTAACATGGTC-1	Invasive	IDC_4
GCGTCTCTGCATTGGG-1	Tumor	DCIS/LCIS_3
GCGTGGTACTGGGTTA-1	Surrounding tumor	Tumor_edge_6
GCGTGTATGTCGTATT-1	Tumor	DCIS/LCIS_5
GCGTTCGGAGACCGGG-1	Healthy	Healthy_1
GCTAAACCTGAGGTGA-1	Surrounding tumor	Tumor_edge_6
GCTAACTGAAGTCTGA-1	Invasive	IDC_2
GCTAAGCCCAGTATGC-1	Invasive	IDC_2
GCTAAGTAAAGGCGAT-1	Surrounding tumor	Tumor_edge_2
GCTAAGTAGTTTCTCT-1	Invasive	IDC_6
GCTAATACCGAATGCC-1	Invasive	IDC_5
GCTACAATCGAGGATA-1	Invasive	IDC_2
GCTACAGTACGGACCG-1	Surrounding tumor	Tumor_edge_2
GCTACGACTTATTGGG-1	Healthy	Healthy_2
GCTACTATAGTAGAGT-1	Surrounding tumor	Tumor_edge_5
GCTAGACCGTCTACTG-1	Tumor	DCIS/LCIS_1
GCTAGAGTAGAGATGT-1	Invasive	IDC_2
GCTAGCAGGGAGTGGG-1	Healthy	Healthy_1
GCTAGCGATAGGTCTT-1	Invasive	IDC_4
GCTAGGCACCACGGAG-1	Invasive	IDC_2
GCTAGTAGAGCTTGTA-1	Invasive	IDC_6
GCTAGTTTCATTGAGG-1	Invasive	IDC_5
GCTATAAGGGCCAGGA-1	Invasive	IDC_2
GCTATACGTCTCGGAC-1	Invasive	IDC_2
GCTATCATACTCATGG-1	Tumor	DCIS/LCIS_4
GCTATCGCGGCGCAAC-1	Invasive	IDC_5
GCTCAATGTAATACCG-1	Tumor	DCIS/LCIS_4
GCTCATTACTGCATGT-1	Healthy	Healthy_1
GCTCCATGCAAAGCAA-1	Invasive	IDC_4
GCTCCCAGTCGGTCCA-1	Tumor	DCIS/LCIS_1
GCTCCGCTCGCTTCAG-1	Tumor	DCIS/LCIS_1
GCTCCTGACATACTGG-1	Invasive	IDC_4
GCTCGCTCATGTCCAA-1	Tumor	DCIS/LCIS_1
GCTCGGAATTTAAAGC-1	Surrounding tumor	Tumor_edge_1
GCTCTAAACCCTGACG-1	Invasive	IDC_7
GCTCTATGTTACGTGC-1	Invasive	IDC_6
GCTCTCGGGTACCGAA-1	Invasive	IDC_7
GCTCTTTCCGCTAGTG-1	Surrounding tumor	Tumor_edge_6
GCTGAACTCTCCAGGG-1	Surrounding tumor	Tumor_edge_3
GCTGAATCTTCCAATC-1	Invasive	IDC_4
GCTGAGGCGTGAGTAT-1	Invasive	IDC_6
GCTGCACGGTTTCTTA-1	Healthy	Healthy_2
GCTGCTAAGTAGTCGA-1	Healthy	Healthy_2
GCTGCTACTGCGTAGC-1	Surrounding tumor	Tumor_edge_6
GCTGCTCTCCGGACAC-1	Invasive	IDC_6
GCTGGACCCAAAGTGG-1	Healthy	Healthy_1
GCTGGCATATTCACCT-1	Tumor	DCIS/LCIS_3
GCTGGCGGCGCATGCT-1	Tumor	DCIS/LCIS_4
GCTGGTGACTCGTAGT-1	Healthy	Healthy_1
GCTGGTTTAGGCCATA-1	Invasive	IDC_4
GCTGTATTACTGGCCC-1	Tumor	DCIS/LCIS_3
GCTGTTGCTACCGAAC-1	Surrounding tumor	Tumor_edge_3
GCTTAATGTAACTAAC-1	Invasive	IDC_1
GCTTACGTAGTTAGTA-1	Tumor	DCIS/LCIS_1
GCTTATGAAGCAGGAA-1	Healthy	Healthy_1
GCTTCAGTGGGATTAC-1	Healthy	Healthy_1
GCTTCCAGCTTAGATT-1	Invasive	IDC_5
GCTTCCATGTAACCGC-1	Invasive	IDC_2
GCTTCCCGTAAGCTCC-1	Surrounding tumor	Tumor_edge_6
GCTTCCGTCCCTAGAC-1	Invasive	IDC_7
GCTTCGACGTTCAATC-1	Invasive	IDC_4
GCTTGAGTGACCTCTG-1	Invasive	IDC_2
GCTTGATGATAATCAG-1	Invasive	IDC_5
GCTTGCAGCACAATTG-1	Healthy	Healthy_1
GCTTGGATCGATTAGG-1	Healthy	Healthy_1
GCTTTACACAACTGGG-1	Invasive	IDC_2
GCTTTCAGAGGAGGTG-1	Healthy	Healthy_1
GCTTTCTATCTCAACT-1	Healthy	Healthy_1
GGAAACCTTGTTGAAT-1	Healthy	Healthy_1
GGAAACTAAATGGGCC-1	Invasive	IDC_2
GGAAAGGGAATTGAGC-1	Surrounding tumor	Tumor_edge_6
GGAAAGTGCCCATGCC-1	Surrounding tumor	Tumor_edge_1
GGAACCGTGTAAATTG-1	Tumor	DCIS/LCIS_3
GGAACCTTGACTCTGC-1	Invasive	IDC_4
GGAACGGCCTGCAGCC-1	Surrounding tumor	Tumor_edge_2
GGAACTTTGGCGATTA-1	Surrounding tumor	Tumor_edge_4
GGAAGCTCGCTTACAG-1	Surrounding tumor	Tumor_edge_1
GGAAGGACACCGTATA-1	Surrounding tumor	Tumor_edge_6
GGAATAACCTCAAGAA-1	Tumor	DCIS/LCIS_5
GGAATGCGCTAGCGTG-1	Invasive	IDC_7
GGACAACCATGAAGCC-1	Invasive	IDC_2
GGACACAAGTTTACAC-1	Surrounding tumor	Tumor_edge_3
GGACACCTCGGTGTTG-1	Invasive	IDC_4
GGACCAACAGGATAAC-1	Healthy	Healthy_2
GGACCTACGGTAACGT-1	Healthy	Healthy_1
GGACCTCTAGGCCGCC-1	Invasive	IDC_4
GGACGGCTTGCGCAAC-1	Healthy	Healthy_1
GGACGGGCGACCAACC-1	Invasive	IDC_2
GGACGTCCATAGTTGG-1	Healthy	Healthy_1
GGACTCGACAGCGCAT-1	Invasive	IDC_4
GGACTCGTGAGTGGTC-1	Invasive	IDC_4
GGACTCTTTGACTAAG-1	Invasive	IDC_2
GGAGAAGTCATTGGCA-1	Invasive	IDC_5
GGAGACCAATGTGCTT-1	Healthy	Healthy_1
GGAGACGACACCTTTG-1	Healthy	Healthy_2
GGAGCAACATTTCAAG-1	Surrounding tumor	Tumor_edge_4
GGAGCACCAAGAACTA-1	Surrounding tumor	Tumor_edge_1
GGAGCGAGGCCTACTT-1	Invasive	IDC_2
GGAGGATTGAAAGGAG-1	Tumor	DCIS/LCIS_5
GGAGGCCGAAGTCGTC-1	Tumor	DCIS/LCIS_1
GGAGGGCTTGGTTGGC-1	Invasive	IDC_7
GGAGGGTCAAGTAAGA-1	Surrounding tumor	Tumor_edge_4
GGAGTGCCGCCCTGGA-1	Invasive	IDC_5
GGAGTTGATTCTGTGT-1	Invasive	IDC_2
GGATACTCATGAATTG-1	Invasive	IDC_5
GGATCAAAGGACGAGG-1	Surrounding tumor	Tumor_edge_1
GGATCATCCCGTACGC-1	Healthy	Healthy_1
GGATCCCTACCAGCTA-1	Invasive	IDC_5
GGATCCGGAATATACT-1	Invasive	IDC_6
GGATCTTACTGCCCTT-1	Invasive	IDC_4
GGATCTTGACTCAACC-1	Invasive	IDC_3
GGATGAAGATCGCTGA-1	Surrounding tumor	Tumor_edge_3
GGATGACGCGAGTTTA-1	Tumor	DCIS/LCIS_3
GGATGCTGGCGTTCCT-1	Surrounding tumor	Tumor_edge_2
GGATGGCTTGAAGTAT-1	Invasive	IDC_2
GGATGTCCTTACCGCA-1	Healthy	Healthy_1
GGATTAAGCTAAGGTC-1	Surrounding tumor	Tumor_edge_1
GGATTAATCATGGACC-1	Invasive	IDC_2
GGATTCAGTACGGTGG-1	Invasive	IDC_5
GGATTCCGCTATACCC-1	Surrounding tumor	Tumor_edge_1
GGATTGCTGTGACTCC-1	Surrounding tumor	Tumor_edge_6
GGATTTCACTTCTATA-1	Invasive	IDC_7
GGCAAAGGCGCCAATA-1	Invasive	IDC_4
GGCAAATTACTTTACT-1	Tumor	DCIS/LCIS_3
GGCAAGCCAGGGATAG-1	Healthy	Healthy_1
GGCAAGCCCATAGTGG-1	Surrounding tumor	Tumor_edge_6
GGCAAGGCGAAATAGC-1	Healthy	Healthy_2
GGCAATAGTCAATGAG-1	Invasive	IDC_7
GGCACGCTGCTACAGT-1	Invasive	IDC_2
GGCACTCCACTGGGCA-1	Tumor	DCIS/LCIS_3
GGCACTGCGGTGGTTT-1	Invasive	IDC_2
GGCAGCAAACCTATGC-1	Surrounding tumor	Tumor_edge_5
GGCAGCGGTAATCCTA-1	Healthy	Healthy_1
GGCATACAGGTAGCGG-1	Tumor	DCIS/LCIS_3
GGCATATCGGTTCTGC-1	Surrounding tumor	Tumor_edge_1
GGCATCAACGAGCACG-1	Surrounding tumor	Tumor_edge_1
GGCATTGAACATCTCA-1	Invasive	IDC_4
GGCCAATTGTATAGAC-1	Invasive	IDC_2
GGCCCAATCTAGAGGG-1	Healthy	Healthy_1
GGCCCAGCTGGTTTGC-1	Invasive	IDC_2
GGCCCAGTTATCAGCA-1	Healthy	Healthy_1
GGCCCGGAGCATGTCT-1	Tumor	DCIS/LCIS_1
GGCCCGTATACCATGC-1	Healthy	Healthy_1
GGCCCTCACCCACTTA-1	Tumor	DCIS/LCIS_3
GGCCGAGACTCTGGTG-1	Invasive	IDC_4
GGCCGCAGGAACCGCA-1	Invasive	IDC_2
GGCCGGCGTCTGCTAT-1	Invasive	IDC_2
GGCCGTTTGGGTTTCA-1	Invasive	IDC_4
GGCCTGCTCTGATGTT-1	Invasive	IDC_4
GGCCTGCTTCTCCCGA-1	Tumor	DCIS/LCIS_2
GGCGAAATCTAACTTG-1	Invasive	IDC_1
GGCGCAGGACATCTTC-1	Tumor	DCIS/LCIS_3
GGCGCATGAATTGATG-1	Tumor	DCIS/LCIS_3
GGCGCGGAGATCTTTC-1	Invasive	IDC_2
GGCGCGTTCGAGTTTA-1	Healthy	Healthy_2
GGCGCTCCTCATCAAT-1	Invasive	IDC_5
GGCGCTTCATTCCCTG-1	Invasive	IDC_2
GGCGGAGTAATATTAG-1	Tumor	DCIS/LCIS_3
GGCGGTAGGATCATTG-1	Surrounding tumor	Tumor_edge_6
GGCGTACCCTATATAA-1	Tumor	DCIS/LCIS_5
GGCGTAGGGAAAGCTG-1	Invasive	IDC_2
GGCGTCCTATCCGCTG-1	Tumor	DCIS/LCIS_3
GGCTAAAGGGCGGGTC-1	Healthy	Healthy_1
GGCTAATGATTGAAAT-1	Healthy	Healthy_1
GGCTACTATACACTCC-1	Invasive	IDC_4
GGCTATTAAGTTGTAT-1	Tumor	DCIS/LCIS_3
GGCTCCTCCACCTGTT-1	Invasive	IDC_4
GGCTCGCGTTGAGGTA-1	Healthy	Healthy_1
GGCTCGTGCCACCAGC-1	Invasive	IDC_5
GGCTCTGCTCCAACGC-1	Invasive	IDC_7
GGCTGAAATAGCAAAG-1	Healthy	Healthy_2
GGCTGAGCATCGTAAG-1	Healthy	Healthy_1
GGCTGGCTAGCTTAAA-1	Invasive	IDC_5
GGCTTTCAATAAGGGT-1	Tumor	DCIS/LCIS_4
GGGAAAGAATGCCAAC-1	Invasive	IDC_2
GGGAACGGGAGGTTAG-1	Tumor	DCIS/LCIS_3
GGGAACGGTTTCAGAT-1	Invasive	IDC_4
GGGAAGACGGTCTGTC-1	Invasive	IDC_2
GGGAAGGGCTTTCTCA-1	Invasive	IDC_2
GGGAATGAGCCCTCAC-1	Healthy	Healthy_1
GGGACAGAGTTACTCC-1	Invasive	IDC_4
GGGACCCGTATATCTT-1	Surrounding tumor	Tumor_edge_6
GGGACTGCATAGATAG-1	Invasive	IDC_6
GGGAGAACTCACAGTA-1	Invasive	IDC_6
GGGAGCGACCGTAGTG-1	Invasive	IDC_2
GGGAGGATGCCCGAAA-1	Tumor	DCIS/LCIS_3
GGGAGTAATGGCTGGC-1	Invasive	IDC_5
GGGAGTTAATGAGGCG-1	Invasive	IDC_6
GGGATCCCAATACAAA-1	Healthy	Healthy_1
GGGATGGTCGTAACCG-1	Tumor	DCIS/LCIS_3
GGGATTTACCGCACCT-1	Invasive	IDC_1
GGGCAACCGCACGTGC-1	Invasive	IDC_4
GGGCACGTAGTACTGT-1	Invasive	IDC_4
GGGCAGAGCAATCGTT-1	Tumor	DCIS/LCIS_4
GGGCAGTCAACGCCAA-1	Invasive	IDC_2
GGGCATGCATGTCGAG-1	Invasive	IDC_4
GGGCCATTCGTGCTGG-1	Invasive	IDC_4
GGGCCCGTCTTAAACA-1	Tumor	DCIS/LCIS_3
GGGCCCTACGAAAGGG-1	Surrounding tumor	Tumor_edge_2
GGGCCGGCCGAAGTAC-1	Surrounding tumor	Tumor_edge_6
GGGCCTATTTAAGTAT-1	Healthy	Healthy_1
GGGCGATATGTGTGAA-1	Invasive	IDC_6
GGGCGCAGCGTTACTC-1	Tumor	DCIS/LCIS_1
GGGCGGGTTCCCTACG-1	Tumor	DCIS/LCIS_3
GGGCGGTCCTATTGTC-1	Invasive	IDC_5
GGGCGTACATTTATAT-1	Invasive	IDC_5
GGGCGTCACCACGTAA-1	Tumor	DCIS/LCIS_3
GGGCGTCCACTGGCTC-1	Surrounding tumor	Tumor_edge_1
GGGCGTGGTTTCCCAG-1	Tumor	DCIS/LCIS_4
GGGCGTTTACATTCAT-1	Invasive	IDC_4
GGGCTCATCGAACCCA-1	Healthy	Healthy_1
GGGCTGCCTAGGGCGA-1	Invasive	IDC_6
GGGCTGGTTAGTCGCG-1	Tumor	DCIS/LCIS_3
GGGTAATGCTGTGTTT-1	Invasive	IDC_5
GGGTACCCACGGTCCT-1	Invasive	IDC_5
GGGTACTTCATGAACT-1	Tumor	DCIS/LCIS_3
GGGTATGTATGCACTT-1	Tumor	DCIS/LCIS_3
GGGTATTCTAGCAAAC-1	Invasive	IDC_4
GGGTCACCGTGACGGT-1	Tumor	DCIS/LCIS_3
GGGTCAGGAGCTAGAT-1	Invasive	IDC_4
GGGTCATGCGTACCAT-1	Surrounding tumor	Tumor_edge_6
GGGTCCTTGGAAGAAG-1	Invasive	IDC_4
GGGTCGTGGCAAGTGT-1	Healthy	Healthy_1
GGGTCTATCGCTTTCC-1	Surrounding tumor	Tumor_edge_4
GGGTGACACCTTAACT-1	Tumor	DCIS/LCIS_3
GGGTGCATATGAAAGC-1	Surrounding tumor	Tumor_edge_3
GGGTGGTCCAGCCTGT-1	Tumor	DCIS/LCIS_5
GGGTGTTTCAGCTATG-1	Surrounding tumor	Tumor_edge_1
GGGTTCAGACGAACAA-1	Invasive	IDC_5
GGGTTTAGGATAGGAT-1	Tumor	DCIS/LCIS_1
GGTAAACTCTGCGCTG-1	Invasive	IDC_2
GGTAAATGTGCGTTAC-1	Tumor	DCIS/LCIS_5
GGTAACCGGGAGGATA-1	Invasive	IDC_4
GGTAACTATGTATCTG-1	Invasive	IDC_5
GGTACAAACATGCTAT-1	Tumor	DCIS/LCIS_3
GGTACACCAGATTTAT-1	Healthy	Healthy_1
GGTACATCTGGGACGA-1	Surrounding tumor	Tumor_edge_2
GGTACCATTAAGACGG-1	Surrounding tumor	Tumor_edge_3
GGTACGTTGCGGCCGG-1	Invasive	IDC_2
GGTAGAAGACCGCCTG-1	Tumor	DCIS/LCIS_4
GGTAGGCCAATATCAC-1	Invasive	IDC_4
GGTAGTGCTCGCACCA-1	Invasive	IDC_6
GGTATAGTGACACATA-1	Tumor	DCIS/LCIS_1
GGTATTGCCGAGTTTA-1	Tumor	DCIS/LCIS_3
GGTCAAGACTACTTCG-1	Surrounding tumor	Tumor_edge_4
GGTCACGTTAGATTCA-1	Invasive	IDC_5
GGTCAGTGGGTCCCAC-1	Healthy	Healthy_2
GGTCATTGTAGTCATA-1	Healthy	Healthy_1
GGTCGGATAAACGGCG-1	Healthy	Healthy_1
GGTCGGCCAGGAGCTT-1	Invasive	IDC_7
GGTCGGTAATTAGACA-1	Invasive	IDC_5
GGTCGTAAGCTCGCAC-1	Invasive	IDC_3
GGTCTCCGTCCAGGTT-1	Invasive	IDC_2
GGTCTCTGAATGGACT-1	Surrounding tumor	Tumor_edge_2
GGTCTGAGAATCTGGA-1	Invasive	IDC_7
GGTCTTGAGCGCTCTT-1	Surrounding tumor	Tumor_edge_6
GGTGAAACCGGGAATG-1	Surrounding tumor	Tumor_edge_1
GGTGAACGGGCTAGCC-1	Invasive	IDC_5
GGTGAAGTACAGGGAT-1	Tumor	DCIS/LCIS_3
GGTGAGATGCAGATAA-1	Invasive	IDC_5
GGTGATAAGGAGCAGT-1	Invasive	IDC_6
GGTGATTTCATCTTGT-1	Invasive	IDC_5
GGTGCAGAGCCTATCG-1	Healthy	Healthy_1
GGTGCATAAATGATTA-1	Invasive	IDC_4
GGTGCGGATAAGTGGC-1	Invasive	IDC_5
GGTGCTGATCACAAAG-1	Surrounding tumor	Tumor_edge_2
GGTGCTGGTACACATT-1	Tumor	DCIS/LCIS_3
GGTGGACCACGTGTTA-1	Healthy	Healthy_1
GGTGGACTGCTCTGGC-1	Invasive	IDC_2
GGTGTAAATCGATTGT-1	Invasive	IDC_2
GGTGTAGGTAAGTAAA-1	Invasive	IDC_4
GGTGTTCTGTTTCTAC-1	Healthy	Healthy_1
GGTTACCACCCTCGGG-1	Tumor	DCIS/LCIS_3
GGTTACCCGACACTTT-1	Surrounding tumor	Tumor_edge_3
GGTTAGCTATATGTCT-1	Surrounding tumor	Tumor_edge_5
GGTTAGGCTTGGAGAA-1	Tumor	DCIS/LCIS_3
GGTTAGTTACGGCGCC-1	Surrounding tumor	Tumor_edge_2
GGTTCCCTAGTGTCTC-1	Surrounding tumor	Tumor_edge_6
GGTTCGATGCTGAGTT-1	Surrounding tumor	Tumor_edge_6
GGTTCGCATTTGCCGT-1	Invasive	IDC_2
GGTTCTACTCGTCTGA-1	Tumor	DCIS/LCIS_1
GGTTGTATCGTGAAAT-1	Tumor	DCIS/LCIS_5
GGTTTAATTACCATCG-1	Invasive	IDC_4
GGTTTAATTGAGCAGG-1	Healthy	Healthy_1
GGTTTACAATCTCAAT-1	Invasive	IDC_7
GGTTTAGCCTTTCTTG-1	Tumor	DCIS/LCIS_1
GGTTTCAATCGGTCAG-1	Healthy	Healthy_1
GGTTTGACAAGAAGCT-1	Healthy	Healthy_1
GGTTTGAGTGCTGGAA-1	Invasive	IDC_5
GGTTTGCGAACACGTA-1	Healthy	Healthy_1
GGTTTGTGACCTGAGG-1	Invasive	IDC_2
GTAACAACTGACCTTG-1	Healthy	Healthy_1
GTAACATCTAAGATAA-1	Tumor	DCIS/LCIS_2
GTAACTGCCCAAGGAG-1	Invasive	IDC_4
GTAACTTGCGGCAGTC-1	Invasive	IDC_5
GTAAGCGGGCAGTCAG-1	Invasive	IDC_7
GTAAGGATTTGTCGGA-1	Tumor	DCIS/LCIS_5
GTAAGTAACAGTCTGG-1	Invasive	IDC_1
GTAAGTAGGGTATACC-1	Surrounding tumor	Tumor_edge_6
GTAAGTCCACACTCTA-1	Surrounding tumor	Tumor_edge_3
GTAATAAAGGGCTCCC-1	Surrounding tumor	Tumor_edge_3
GTACACTTACCTGAAG-1	Invasive	IDC_6
GTACAGAGGCAAGGGT-1	Surrounding tumor	Tumor_edge_6
GTACGACGGCGCTGCG-1	Invasive	IDC_5
GTACGAGATTGCGACA-1	Invasive	IDC_5
GTACGTCACGTATTAA-1	Healthy	Healthy_1
GTACGTTTGCCCGTCA-1	Healthy	Healthy_2
GTACTAAGATTTGGAG-1	Invasive	IDC_6
GTACTCCCTTATCGCT-1	Tumor	DCIS/LCIS_3
GTACTCCTGGGTATGC-1	Healthy	Healthy_1
GTACTGAGGTCGTAAC-1	Invasive	IDC_5
GTACTGCATGAAGCGT-1	Invasive	IDC_5
GTACTGGAGTTAGACC-1	Invasive	IDC_6
GTACTTGGGCACTTCT-1	Invasive	IDC_5
GTAGAAACGGGTGGAG-1	Surrounding tumor	Tumor_edge_2
GTAGACAACCGATGAA-1	Surrounding tumor	Tumor_edge_1
GTAGACACGCCTGACT-1	Tumor	DCIS/LCIS_4
GTAGACGTCGTTACAT-1	Invasive	IDC_5
GTAGAGGGAGACAAGT-1	Surrounding tumor	Tumor_edge_2
GTAGCCAAACATGGGA-1	Healthy	Healthy_2
GTAGCGCTGTTGTAGT-1	Surrounding tumor	Tumor_edge_1
GTAGCGGCTATACACT-1	Invasive	IDC_6
GTAGCTAGTAAGCGCG-1	Surrounding tumor	Tumor_edge_6
GTAGCTCCGGGAGGCT-1	Invasive	IDC_4
GTAGCTTCCTCTTGTT-1	Healthy	Healthy_1
GTAGGTGATCCGTGTA-1	Surrounding tumor	Tumor_edge_1
GTAGTCGCGGGAATCA-1	Healthy	Healthy_2
GTAGTCTACGATATTG-1	Surrounding tumor	Tumor_edge_6
GTAGTGAGCAACCTCA-1	Invasive	IDC_2
GTAGTTCGAAGGCGAA-1	Invasive	IDC_4
GTATAATCTCCCGGAT-1	Invasive	IDC_5
GTATAGGACTCAGTAG-1	Invasive	IDC_5
GTATAGTGGCCCATGT-1	Healthy	Healthy_1
GTATATGTTACGGCGG-1	Invasive	IDC_5
GTATCAAACGTTAGCT-1	Invasive	IDC_2
GTATCAAGGTACTTCC-1	Surrounding tumor	Tumor_edge_6
GTATCAGCTTGGGTTC-1	Invasive	IDC_5
GTATCCTTTGGTAACC-1	Invasive	IDC_2
GTATCGGGACGAGCTG-1	Invasive	IDC_5
GTATCTCAGTCTTGAC-1	Invasive	IDC_4
GTATCTCCCTAACTGT-1	Tumor	DCIS/LCIS_5
GTATCTCGGGCGCTTT-1	Invasive	IDC_4
GTATCTTGTTGCTCAC-1	Surrounding tumor	Tumor_edge_6
GTATCTTTCATAACCA-1	Healthy	Healthy_2
GTATGAAATTTCACTC-1	Invasive	IDC_3
GTATGACGTGGGAAAC-1	Invasive	IDC_5
GTATGTGGGTCTAGTT-1	Invasive	IDC_1
GTATTAAGGCGTCTAA-1	Invasive	IDC_5
GTATTAGGGTTCGCGT-1	Healthy	Healthy_1
GTATTCTGAGAAACGA-1	Tumor	DCIS/LCIS_3
GTATTCTTACCGTGCT-1	Invasive	IDC_5
GTATTTAATGGCATAA-1	Surrounding tumor	Tumor_edge_3
GTCAAAGAAGTGGTGT-1	Surrounding tumor	Tumor_edge_6
GTCAAAGTTTACATAG-1	Invasive	IDC_5
GTCAACCAGGCCTATA-1	Invasive	IDC_2
GTCAAGCGGACTCGGG-1	Invasive	IDC_6
GTCAATGCTATAATTT-1	Healthy	Healthy_1
GTCAATTGTACTGAAG-1	Surrounding tumor	Tumor_edge_1
GTCACAAAGTTTCCAA-1	Surrounding tumor	Tumor_edge_6
GTCACTCTCCAAATCT-1	Invasive	IDC_5
GTCAGAATAGTCTATG-1	Tumor	DCIS/LCIS_3
GTCAGTTGTGCTCGTT-1	Tumor	DCIS/LCIS_5
GTCAGTTTGGTAGTCG-1	Surrounding tumor	Tumor_edge_2
GTCATCTCCTACAGCT-1	Invasive	IDC_5
GTCATGCACCTCCGTT-1	Invasive	IDC_6
GTCATGCGCGAGGGCT-1	Invasive	IDC_2
GTCATGGACATGACTA-1	Invasive	IDC_7
GTCATTAGAGCGAACG-1	Invasive	IDC_6
GTCCAATATTTAGCCT-1	Invasive	IDC_4
GTCCAGGCACGTGTGC-1	Invasive	IDC_4
GTCCATTACTGCTACG-1	Tumor	DCIS/LCIS_1
GTCCCAACGTAAAGTA-1	Invasive	IDC_6
GTCCCGCGACGTTATG-1	Tumor	DCIS/LCIS_4
GTCCGGACCTGAAATT-1	Invasive	IDC_2
GTCCGGCTGAATTGCG-1	Invasive	IDC_6
GTCCGGGTTCACATTA-1	Invasive	IDC_2
GTCCTACAGGCGGCTC-1	Invasive	IDC_5
GTCCTACGAATAGTCT-1	Invasive	IDC_2
GTCCTTCTAGTGGGTT-1	Surrounding tumor	Tumor_edge_6
GTCCTTTAATGACTTC-1	Healthy	Healthy_1
GTCGAATTTGGGCGCT-1	Invasive	IDC_4
GTCGCGTAACCCGTTG-1	Invasive	IDC_6
GTCGGAAGGATACCAG-1	Healthy	Healthy_1
GTCGGATATCTCAGAC-1	Tumor	DCIS/LCIS_3
GTCGGATGTAGCGCGC-1	Surrounding tumor	Tumor_edge_1
GTCGGGAAGCAGAAAC-1	Tumor	DCIS/LCIS_4
GTCGGGTGAAGTACCG-1	Invasive	IDC_2
GTCGTACCATCTCGGG-1	Healthy	Healthy_2
GTCGTATTGGCGTACA-1	Healthy	Healthy_1
GTCGTCAATTATAAGG-1	Invasive	IDC_5
GTCGTCTGGTTGGCTA-1	Surrounding tumor	Tumor_edge_3
GTCGTGTCTGGTCATC-1	Surrounding tumor	Tumor_edge_3
GTCTAGTGAGCCGCTT-1	Invasive	IDC_2
GTCTATCTGAGTTTCT-1	Tumor	DCIS/LCIS_3
GTCTATTGCATGCTCG-1	Invasive	IDC_2
GTCTATTGGTTCCGGT-1	Surrounding tumor	Tumor_edge_5
GTCTCAAGGCCCGGCT-1	Tumor	DCIS/LCIS_4
GTCTCCCGAGTCCCGT-1	Invasive	IDC_2
GTCTCCGCCTCAATAC-1	Invasive	IDC_4
GTCTCCTGCCAGTATG-1	Invasive	IDC_4
GTCTCGACTAAGTTTG-1	Healthy	Healthy_1
GTCTCGATCTGCTTTC-1	Surrounding tumor	Tumor_edge_1
GTCTCGCCAACACGCC-1	Tumor	DCIS/LCIS_5
GTCTGCCGACTCGACG-1	Surrounding tumor	Tumor_edge_6
GTCTGGGCGGTCGAGA-1	Tumor	DCIS/LCIS_3
GTCTTACCACGCCAAG-1	Invasive	IDC_2
GTCTTAGTACAGCCGG-1	Surrounding tumor	Tumor_edge_6
GTCTTGAGGAGCAGTG-1	Tumor	DCIS/LCIS_1
GTCTTGTAGCTATTCA-1	Surrounding tumor	Tumor_edge_6
GTGAAACGGCGCCACC-1	Healthy	Healthy_1
GTGAAACGTGCTCCAC-1	Invasive	IDC_5
GTGAACTCCCATTCGA-1	Surrounding tumor	Tumor_edge_3
GTGAAGATTTCAAGTG-1	Healthy	Healthy_1
GTGAAGCCGTATAGTC-1	Healthy	Healthy_1
GTGACAGCTTCCCACT-1	Invasive	IDC_2
GTGACCGCACACTACG-1	Invasive	IDC_1
GTGACGAGGGTGACCC-1	Tumor	DCIS/LCIS_1
GTGACGCAGGTTTCAT-1	Invasive	IDC_2
GTGACTTCAGTAGTGC-1	Tumor	DCIS/LCIS_3
GTGAGATAACCTTATA-1	Invasive	IDC_4
GTGAGCGTGCTGCACT-1	Tumor	DCIS/LCIS_3
GTGAGGACACTTAAGG-1	Healthy	Healthy_2
GTGAGGAGCGGTTGAG-1	Surrounding tumor	Tumor_edge_1
GTGAGTCGACTAATAG-1	Invasive	IDC_2
GTGATCAAGCGTGCAC-1	Invasive	IDC_4
GTGATCACTAACGCCT-1	Surrounding tumor	Tumor_edge_3
GTGATCATAGATCTGC-1	Tumor	DCIS/LCIS_3
GTGATCCTTGTCATGA-1	Invasive	IDC_2
GTGATGCACAACATCT-1	Healthy	Healthy_1
GTGATTCGCCGCTCAA-1	Tumor	DCIS/LCIS_3
GTGCAACAAATGTGGC-1	Invasive	IDC_5
GTGCACCAGCTTCAAC-1	Invasive	IDC_4
GTGCACGAAAGTGACT-1	Surrounding tumor	Tumor_edge_6
GTGCCATCACACGGTG-1	Tumor	DCIS/LCIS_3
GTGCCGCTTCAAAGGT-1	Tumor	DCIS/LCIS_3
GTGCCTCAGTGTACGG-1	Healthy	Healthy_1
GTGCCTGAGACCAAAC-1	Invasive	IDC_2
GTGCGAAATCGAACAC-1	Tumor	DCIS/LCIS_3
GTGCGACAGGGAGTGT-1	Tumor	DCIS/LCIS_1
GTGCGCAGCTTGCTCC-1	Invasive	IDC_5
GTGCGGGACCATCGGC-1	Surrounding tumor	Tumor_edge_6
GTGCGGGTCTCCAAAT-1	Invasive	IDC_5
GTGCGTGTATATGAGC-1	Invasive	IDC_1
GTGCTCAAGTACTGTC-1	Tumor	DCIS/LCIS_3
GTGCTTACATCAGCGC-1	Surrounding tumor	Tumor_edge_3
GTGGAACCTACATGCG-1	Surrounding tumor	Tumor_edge_1
GTGGACCAACCCGATT-1	Tumor	DCIS/LCIS_3
GTGGACGCATTTGTCC-1	Tumor	DCIS/LCIS_4
GTGGACGTGCTGAGAC-1	Invasive	IDC_5
GTGGAGCGTTTACCGA-1	Invasive	IDC_4
GTGGCAAACAGCGGCA-1	Invasive	IDC_3
GTGGCCGGTTTCTCGG-1	Invasive	IDC_4
GTGGCGGGCCGTAGCT-1	Tumor	DCIS/LCIS_5
GTGGCGGTCCCAGCGT-1	Surrounding tumor	Tumor_edge_2
GTGGCTGTTTCTGTTC-1	Invasive	IDC_2
GTGGGAACAAACCGGG-1	Invasive	IDC_4
GTGGGAAGACTGAATC-1	Surrounding tumor	Tumor_edge_2
GTGGGCTTAGACACAC-1	Tumor	DCIS/LCIS_3
GTGGTCAGCGAAGTAT-1	Healthy	Healthy_1
GTGGTTACTTCTTTCG-1	Surrounding tumor	Tumor_edge_3
GTGGTTTCCGCCTTTC-1	Tumor	DCIS/LCIS_3
GTGTACCTTGGCTACG-1	Invasive	IDC_7
GTGTATATCAGCGGGC-1	Tumor	DCIS/LCIS_4
GTGTATGACTTTAAAG-1	Surrounding tumor	Tumor_edge_1
GTGTCAGTGTACGTGG-1	Invasive	IDC_4
GTGTCGTATAGCGTTC-1	Tumor	DCIS/LCIS_4
GTGTCGTATTCACCTT-1	Healthy	Healthy_1
GTGTGAATAACTTAGG-1	Surrounding tumor	Tumor_edge_6
GTGTTACTATGCGTCC-1	Healthy	Healthy_2
GTTAAAGTAGGACTGG-1	Surrounding tumor	Tumor_edge_5
GTTAACATCACTTAAA-1	Tumor	DCIS/LCIS_4
GTTAACTATGTTGTCA-1	Tumor	DCIS/LCIS_1
GTTAAGGGTGCGATGT-1	Tumor	DCIS/LCIS_4
GTTAAGTTAGAGTGGG-1	Tumor	DCIS/LCIS_1
GTTACAATTGGTGACG-1	Tumor	DCIS/LCIS_3
GTTACCTACAACTTGC-1	Healthy	Healthy_2
GTTACTTTGGGCCTAG-1	Tumor	DCIS/LCIS_3
GTTAGAGTGTGCCGCT-1	Tumor	DCIS/LCIS_5
GTTAGCCCATGACATC-1	Invasive	IDC_2
GTTAGCCGTAAATCAA-1	Surrounding tumor	Tumor_edge_3
GTTAGGCTACCCGTTT-1	Invasive	IDC_3
GTTATAATACGGTGAA-1	Surrounding tumor	Tumor_edge_4
GTTATATCAGGAGCCA-1	Healthy	Healthy_1
GTTATATTATCTCCCT-1	Healthy	Healthy_2
GTTATCAAGCTATCGA-1	Invasive	IDC_2
GTTATCACCTTCTGAA-1	Tumor	DCIS/LCIS_5
GTTATTAAATACGACC-1	Surrounding tumor	Tumor_edge_1
GTTATTAACGTGGGAG-1	Surrounding tumor	Tumor_edge_6
GTTCAATCTATGTCAA-1	Surrounding tumor	Tumor_edge_1
GTTCACAGGAGTCTAG-1	Tumor	DCIS/LCIS_3
GTTCAGTCGCCAAATG-1	Invasive	IDC_4
GTTCATCGTTTGGCTG-1	Tumor	DCIS/LCIS_1
GTTCCAAGACAGCGAC-1	Invasive	IDC_5
GTTCCAGTCTGACCAT-1	Invasive	IDC_5
GTTCCCGTAAACATAT-1	Surrounding tumor	Tumor_edge_4
GTTCCGTCCGCCTGCA-1	Invasive	IDC_4
GTTCGACAATTGTATA-1	Invasive	IDC_4
GTTCGCCATAAGTGCC-1	Tumor	DCIS/LCIS_3
GTTCGCTGAGACGTCT-1	Surrounding tumor	Tumor_edge_4
GTTCGGAGCACTCAAC-1	Surrounding tumor	Tumor_edge_4
GTTCGGATCGGGAACA-1	Tumor	DCIS/LCIS_1
GTTCGGGCGTACCATT-1	Tumor	DCIS/LCIS_1
GTTCGTCTAAAGAACT-1	Invasive	IDC_2
GTTCGTCTGGGTCCCT-1	Healthy	Healthy_1
GTTCTTCCCTCGATGT-1	Invasive	IDC_5
GTTCTTGTAACTCAAT-1	Invasive	IDC_4
GTTGAACCGGTTCCAT-1	Tumor	DCIS/LCIS_3
GTTGAGTCCCGCCGGT-1	Tumor	DCIS/LCIS_4
GTTGCACGGAGTTTCG-1	Invasive	IDC_5
GTTGCGCTAACATTAC-1	Surrounding tumor	Tumor_edge_3
GTTGCGGACGGTCAGG-1	Surrounding tumor	Tumor_edge_3
GTTGGACCGCATCAGG-1	Healthy	Healthy_1
GTTGGATTCAGTGGCT-1	Healthy	Healthy_1
GTTGGATTGAGAACAC-1	Healthy	Healthy_1
GTTGGATTTGCGTTGG-1	Tumor	DCIS/LCIS_3
GTTGGTCATGCTATCC-1	Tumor	DCIS/LCIS_4
GTTGTAGATTTATGAG-1	Invasive	IDC_4
GTTGTCGTGTTAGTTG-1	Invasive	IDC_5
GTTGTTACATTGCGCT-1	Healthy	Healthy_1
GTTTACGTTCCATCTG-1	Healthy	Healthy_2
GTTTCAAACGAGTTGT-1	Surrounding tumor	Tumor_edge_4
GTTTCATATCGTCGCT-1	Tumor	DCIS/LCIS_3
GTTTCCTGGAGGGTGA-1	Invasive	IDC_6
GTTTCTAGAGGCGCGG-1	Invasive	IDC_2
GTTTCTGCAGTCTCCC-1	Invasive	IDC_6
GTTTGACCAAATCCTA-1	Invasive	IDC_6
GTTTGGCCCAAGTTAT-1	Invasive	IDC_1
GTTTGGCCGCTCAGCG-1	Invasive	IDC_5
GTTTGGCGTCAGGCAC-1	Surrounding tumor	Tumor_edge_6
GTTTGGGCTTGTGAGC-1	Healthy	Healthy_2
GTTTGGGTTTCGCCCG-1	Invasive	IDC_2
GTTTGGTGATCGGTGC-1	Invasive	IDC_4
TAAACGTCGTCAATGA-1	Invasive	IDC_5
TAAAGACAACCCTTTA-1	Surrounding tumor	Tumor_edge_6
TAAAGAGCCCGAAACC-1	Invasive	IDC_5
TAAAGCGGTATTTCCA-1	Invasive	IDC_4
TAAAGCGTTAGGAGAA-1	Healthy	Healthy_1
TAAAGCTGCAATAGGG-1	Healthy	Healthy_1
TAAAGTGCACGTCTCG-1	Invasive	IDC_4
TAAATCTTTACACCTC-1	Healthy	Healthy_1
TAAATGAATCCGTTTC-1	Invasive	IDC_5
TAAATGCCGTCTCATG-1	Healthy	Healthy_1
TAAATTGTGGGTAAAG-1	Invasive	IDC_4
TAAATTTAGTAACACC-1	Invasive	IDC_4
TAACAAAGGGAGAAGC-1	Invasive	IDC_5
TAACAATATTTGTTGC-1	Surrounding tumor	Tumor_edge_2
TAACAGCGTTTGTGCT-1	Invasive	IDC_4
TAACAGGTTCCCTTAG-1	Invasive	IDC_4
TAACATACAATGTGGG-1	Invasive	IDC_6
TAACATACACGCGATC-1	Invasive	IDC_4
TAACCGCCCGCAGTGC-1	Invasive	IDC_5
TAACCTACCGTCCGAG-1	Surrounding tumor	Tumor_edge_3
TAACCTAGGGAGTCCA-1	Surrounding tumor	Tumor_edge_4
TAACGCTTTGAGAGCG-1	Surrounding tumor	Tumor_edge_2
TAACTATCGAAGGTCC-1	Invasive	IDC_5
TAACTATTACGCCAAA-1	Surrounding tumor	Tumor_edge_3
TAACTCATCCGCGCGG-1	Tumor	DCIS/LCIS_3
TAACTCCATGGAGGCT-1	Invasive	IDC_5
TAACTGAAATACGCCT-1	Invasive	IDC_4
TAAGAGGGACAGGGAC-1	Invasive	IDC_4
TAAGCAGGCGACACGC-1	Surrounding tumor	Tumor_edge_2
TAAGCCCTTACGACCA-1	Healthy	Healthy_1
TAAGCGCGAATCAAAT-1	Invasive	IDC_4
TAAGGAACTTGTGGGA-1	Invasive	IDC_5
TAAGGCAACATAAGAT-1	Invasive	IDC_7
TAAGGCCCGTCACCCT-1	Tumor	DCIS/LCIS_4
TAAGGCTGAATCCCTC-1	Tumor	DCIS/LCIS_1
TAAGGGCCTGTCCGAT-1	Invasive	IDC_2
TAAGGGCTGGGAGAGG-1	Surrounding tumor	Tumor_edge_2
TAAGTAAATGTGCCGC-1	Healthy	Healthy_1
TAAGTAACATCTTGAC-1	Tumor	DCIS/LCIS_3
TAAGTCGCCGAGTATC-1	Invasive	IDC_4
TAAGTTGCGACGTAGG-1	Invasive	IDC_2
TAATAAACAAGGAGAT-1	Surrounding tumor	Tumor_edge_1
TAATACACAGTAGTAT-1	Invasive	IDC_5
TAATACTAGAACAGAC-1	Invasive	IDC_2
TAATAGAACAGAGTTA-1	Surrounding tumor	Tumor_edge_2
TAATAGGTCACCAGAA-1	Invasive	IDC_4
TAATAGTGACGACCAG-1	Surrounding tumor	Tumor_edge_1
TAATATTGAAATTCGC-1	Invasive	IDC_5
TAATCGATCCGTACGT-1	Healthy	Healthy_1
TAATGAAAGACCCTTG-1	Surrounding tumor	Tumor_edge_2
TAATTACGTCAGTAGA-1	Invasive	IDC_2
TAATTAGATGGATATG-1	Invasive	IDC_5
TAATTAGGACATCCGT-1	Tumor	DCIS/LCIS_1
TAATTGCGCTGATTAC-1	Invasive	IDC_4
TAATTGGAATCGGGAA-1	Healthy	Healthy_1
TACAACAGCGCATACA-1	Invasive	IDC_2
TACAACGCACAACTCA-1	Tumor	DCIS/LCIS_3
TACAAGCTGTTCACTG-1	Tumor	DCIS/LCIS_5
TACAAGGGCTTCTTTA-1	Invasive	IDC_2
TACAAGTCTCGTGCAT-1	Tumor	DCIS/LCIS_3
TACACAGCCGTGGTGC-1	Invasive	IDC_2
TACACCGTCGTTAGTC-1	Healthy	Healthy_1
TACACCTCTTCGAATC-1	Invasive	IDC_2
TACAGAAACGGTGGGC-1	Invasive	IDC_2
TACATAGGCATACACC-1	Tumor	DCIS/LCIS_3
TACATCCCTATCCCTG-1	Surrounding tumor	Tumor_edge_2
TACATTTCTAACGTGC-1	Tumor	DCIS/LCIS_3
TACCAAATAGCCCAGA-1	Tumor	DCIS/LCIS_4
TACCAATAAAGTACCA-1	Tumor	DCIS/LCIS_4
TACCAGAAGTAGGTTC-1	Tumor	DCIS/LCIS_3
TACCAGCTAGGTTTAA-1	Surrounding tumor	Tumor_edge_1
TACCAGGAATCCCGTC-1	Invasive	IDC_4
TACCGAATAATTGTAA-1	Invasive	IDC_2
TACCGCGGACTTGCAG-1	Healthy	Healthy_1
TACCGGCTCACTGCCC-1	Healthy	Healthy_2
TACCGGTCGTTTCCAT-1	Tumor	DCIS/LCIS_3
TACCGTAGGTTAACTA-1	Tumor	DCIS/LCIS_4
TACCGTGCCTCGGACC-1	Healthy	Healthy_2
TACCTACTCCCAGTAT-1	Tumor	DCIS/LCIS_4
TACCTCACGCTTGTAC-1	Invasive	IDC_5
TACCTCAGTTGTCTGT-1	Invasive	IDC_4
TACCTCCACACCAATG-1	Invasive	IDC_4
TACCTGCTGCACTGTG-1	Tumor	DCIS/LCIS_3
TACCTTAAGATTTCCC-1	Surrounding tumor	Tumor_edge_2
TACGAACACGACTTCA-1	Surrounding tumor	Tumor_edge_6
TACGACGCTTGCTGCG-1	Tumor	DCIS/LCIS_3
TACGACTGCCTCTTAG-1	Healthy	Healthy_2
TACGAGAACTTCACGT-1	Tumor	DCIS/LCIS_3
TACGATGTTGATCATC-1	Tumor	DCIS/LCIS_3
TACGCAGTTCTTTCCT-1	Tumor	DCIS/LCIS_3
TACGCCATATTCTAAT-1	Tumor	DCIS/LCIS_3
TACGCCGAGGGTACCC-1	Invasive	IDC_4
TACGCCTCCATTCCGA-1	Tumor	DCIS/LCIS_4
TACGCTATAGAAACCT-1	Tumor	DCIS/LCIS_1
TACGCTCCTAGAACTG-1	Invasive	IDC_4
TACGCTCGGTATTGGA-1	Surrounding tumor	Tumor_edge_4
TACGCTGCACGGTCGT-1	Invasive	IDC_2
TACGCTGCTGTGTTAA-1	Invasive	IDC_4
TACGGAAGCCAAACCA-1	Invasive	IDC_2
TACGGCATGGACGCTA-1	Surrounding tumor	Tumor_edge_4
TACGGGATGCTAGCAG-1	Surrounding tumor	Tumor_edge_1
TACGGGTAATAACATA-1	Invasive	IDC_2
TACGTAAAGCGGAGTG-1	Invasive	IDC_2
TACGTACTAGTGCTGA-1	Invasive	IDC_4
TACGTGCACTATGCTG-1	Invasive	IDC_5
TACGTGGGCCCAGGGC-1	Invasive	IDC_2
TACGTTTACCGGCAAT-1	Tumor	DCIS/LCIS_3
TACTACGTGCAATGCG-1	Invasive	IDC_2
TACTCCTCTAGTTGAC-1	Invasive	IDC_4
TACTCGTTTGAATCAA-1	Invasive	IDC_2
TACTCTCCGAACAAAT-1	Surrounding tumor	Tumor_edge_1
TACTCTTACTTTACTG-1	Tumor	DCIS/LCIS_2
TACTGCAATCAATTAC-1	Healthy	Healthy_1
TACTGGACAGCTCGGC-1	Tumor	DCIS/LCIS_3
TACTGTTTCTCTGGTA-1	Surrounding tumor	Tumor_edge_3
TACTTAAACATGTACA-1	Invasive	IDC_2
TACTTTACTGAGCCGG-1	Healthy	Healthy_1
TACTTTCCGCACGCCA-1	Surrounding tumor	Tumor_edge_6
TAGAAACCACTAAGTA-1	Tumor	DCIS/LCIS_5
TAGAAAGGTGGCGCTA-1	Invasive	IDC_7
TAGAATAGCCGATGAA-1	Invasive	IDC_2
TAGAATTAAGGGCAAC-1	Tumor	DCIS/LCIS_5
TAGACGAAACGCCAAT-1	Tumor	DCIS/LCIS_4
TAGACGCCCGTACCGG-1	Healthy	Healthy_1
TAGACTACCTAGCGTT-1	Tumor	DCIS/LCIS_1
TAGACTCAGTTGGCCT-1	Invasive	IDC_4
TAGAGATCATGCAACT-1	Surrounding tumor	Tumor_edge_2
TAGAGCTACGAAGAAC-1	Invasive	IDC_5
TAGAGGGAGTTTATCT-1	Invasive	IDC_4
TAGAGGTTCTACTTGT-1	Invasive	IDC_2
TAGAGTCTAAGCGAAC-1	Invasive	IDC_6
TAGAGTGTTCCGGGTA-1	Invasive	IDC_2
TAGATATGGACTGGAA-1	Tumor	DCIS/LCIS_3
TAGATCCGAAGTCGCA-1	Tumor	DCIS/LCIS_5
TAGATGGTTCCTTACT-1	Invasive	IDC_2
TAGATTCAAAGTGCGG-1	Invasive	IDC_4
TAGATTCCTGGTTATT-1	Tumor	DCIS/LCIS_3
TAGATTCTCTAGCAAA-1	Invasive	IDC_2
TAGCAACCTGTCACAA-1	Invasive	IDC_5
TAGCAGATACTTAGGG-1	Invasive	IDC_2
TAGCAGTATGACTAAA-1	Invasive	IDC_2
TAGCCATTTCAAAGTC-1	Invasive	IDC_1
TAGCCGGCGGTCAGCG-1	Surrounding tumor	Tumor_edge_6
TAGCGTCCCTCGATTG-1	Surrounding tumor	Tumor_edge_3
TAGCGTCCGGTGTGGT-1	Tumor	DCIS/LCIS_4
TAGCGTTGGGTCTTAC-1	Invasive	IDC_6
TAGCTAAGTCCGGGAG-1	Invasive	IDC_6
TAGCTAGTGATGATGG-1	Invasive	IDC_4
TAGCTCAGATCCTAGT-1	Healthy	Healthy_1
TAGCTGATGTGAAGCG-1	Surrounding tumor	Tumor_edge_2
TAGGAACAGCCTCCAG-1	Surrounding tumor	Tumor_edge_1
TAGGAGGCTCGAGAAC-1	Invasive	IDC_2
TAGGCATGTTACGCCA-1	Surrounding tumor	Tumor_edge_1
TAGGCCTATATAGTCT-1	Invasive	IDC_2
TAGGCGATGAGGTCTC-1	Invasive	IDC_3
TAGGCGGCTGCAAAGA-1	Invasive	IDC_4
TAGGCTAAAGTGGCAC-1	Invasive	IDC_2
TAGGGAGCTTGGGATG-1	Surrounding tumor	Tumor_edge_3
TAGGGTGTTTCAAGAG-1	Invasive	IDC_5
TAGGTCCAAGTAAGGA-1	Tumor	DCIS/LCIS_3
TAGGTCGCCGGAACTG-1	Surrounding tumor	Tumor_edge_3
TAGGTGACGATAACCT-1	Tumor	DCIS/LCIS_4
TAGGTGAGCCCTACTC-1	Tumor	DCIS/LCIS_3
TAGGTGCTCGCCTAGC-1	Invasive	IDC_1
TAGGTGTTCCACAGAT-1	Tumor	DCIS/LCIS_4
TAGGTTCGAGTTCGTC-1	Invasive	IDC_6
TAGGTTCTGCTGAGAA-1	Invasive	IDC_4
TAGTACCACAACTTTC-1	Invasive	IDC_4
TAGTACCTTAGTGGTC-1	Invasive	IDC_5
TAGTAGCTTATACCAG-1	Invasive	IDC_4
TAGTCCCGGAGACCAC-1	Invasive	IDC_4
TAGTCCGCAGAGAATG-1	Tumor	DCIS/LCIS_3
TAGTCCGTATGCATAA-1	Invasive	IDC_5
TAGTCCTGCACTAAGC-1	Invasive	IDC_4
TAGTCGATCACGGGTT-1	Surrounding tumor	Tumor_edge_5
TAGTCTAACAACGAGA-1	Tumor	DCIS/LCIS_3
TAGTCTGCGGCACATT-1	Invasive	IDC_4
TAGTCTGTGACGTTGC-1	Healthy	Healthy_1
TAGTCTTTCCGAATTG-1	Surrounding tumor	Tumor_edge_3
TAGTGCCCTCCAGAGT-1	Tumor	DCIS/LCIS_3
TAGTGGAACTCATACA-1	Surrounding tumor	Tumor_edge_1
TAGTGTCAGAAACGGC-1	Invasive	IDC_5
TAGTTAAGATAGGATA-1	Surrounding tumor	Tumor_edge_1
TAGTTTATTCTTGCTT-1	Invasive	IDC_5
TATAAATCCACAAGCT-1	Invasive	IDC_5
TATAAGTGAGGATAGC-1	Invasive	IDC_5
TATACACGCAAAGTAT-1	Invasive	IDC_5
TATACCGAGTGCCACA-1	Surrounding tumor	Tumor_edge_3
TATACGCGTCATCACT-1	Tumor	DCIS/LCIS_4
TATACTCATGCGGCAA-1	Invasive	IDC_5
TATAGAGTCGCTTGAA-1	Invasive	IDC_4
TATAGATGGTCGCAGT-1	Tumor	DCIS/LCIS_1
TATAGGGTACTCATGA-1	Tumor	DCIS/LCIS_3
TATAGTTAGGTGTACT-1	Invasive	IDC_4
TATATAGGGCTTTACG-1	Invasive	IDC_4
TATATATCGAGAAATG-1	Invasive	IDC_4
TATATCAAAGTGATCT-1	Invasive	IDC_4
TATATCCCTGGGAGGA-1	Surrounding tumor	Tumor_edge_3
TATATTACAAATGTCG-1	Healthy	Healthy_1
TATATTCGCGTCGATA-1	Tumor	DCIS/LCIS_5
TATCACAGCACGGGCA-1	Tumor	DCIS/LCIS_5
TATCACCATGTAAAGT-1	Healthy	Healthy_1
TATCACCCAACCGACC-1	Healthy	Healthy_1
TATCACTTCGAGTAAC-1	Healthy	Healthy_1
TATCCAATTGGTTATC-1	Tumor	DCIS/LCIS_4
TATCCATATCATGCGA-1	Invasive	IDC_5
TATCCATCTCGGTTAG-1	Invasive	IDC_4
TATCCGCACCGTCGGG-1	Healthy	Healthy_2
TATCCTATCAACTGGT-1	Invasive	IDC_4
TATCCTGCATGGGAAT-1	Invasive	IDC_5
TATCGATCTATGCATA-1	Surrounding tumor	Tumor_edge_1
TATCGATGATTAAACG-1	Invasive	IDC_5
TATCTACAGAGGTAAT-1	Tumor	DCIS/LCIS_3
TATCTACCACAGCGGG-1	Tumor	DCIS/LCIS_3
TATCTGAGCCGATATT-1	Invasive	IDC_4
TATCTTGCAATACAAC-1	Invasive	IDC_4
TATGAAGAATTAAGGT-1	Invasive	IDC_2
TATGAAGACAGGTGCG-1	Tumor	DCIS/LCIS_3
TATGATAAATCTAACG-1	Tumor	DCIS/LCIS_5
TATGATCCGGCACGCC-1	Surrounding tumor	Tumor_edge_6
TATGATCTTCTCTTTA-1	Invasive	IDC_2
TATGATTCTGCTTGGT-1	Invasive	IDC_5
TATGCTCCCTACTTAC-1	Invasive	IDC_7
TATGGAGTTTCTCGTT-1	Invasive	IDC_5
TATGGATGTGCTACGC-1	Surrounding tumor	Tumor_edge_6
TATGGCCCGGCCTCGC-1	Tumor	DCIS/LCIS_3
TATGGGACCGAGCAGG-1	Tumor	DCIS/LCIS_3
TATGGGTACGTATCGT-1	Invasive	IDC_6
TATGGTCTGAGTAACA-1	Tumor	DCIS/LCIS_3
TATGGTTAGTGGGAGA-1	Tumor	DCIS/LCIS_1
TATGTAAAGTGCTTAA-1	Invasive	IDC_4
TATGTCAAGACCGACT-1	Surrounding tumor	Tumor_edge_6
TATGTCTCATTGTGCC-1	Invasive	IDC_7
TATTAACACCAAAGCA-1	Invasive	IDC_3
TATTACCATCCTGCTT-1	Surrounding tumor	Tumor_edge_3
TATTATGTTTGCCTGC-1	Invasive	IDC_4
TATTCAATTCTAATCC-1	Invasive	IDC_6
TATTCCGAGCTGTTAT-1	Invasive	IDC_2
TATTCCGGCAGTCCTA-1	Tumor	DCIS/LCIS_5
TATTCCTCCGCCCACT-1	Surrounding tumor	Tumor_edge_2
TATTCGTGCCAGAATA-1	Invasive	IDC_6
TATTGACATTTCTGCC-1	Tumor	DCIS/LCIS_1
TATTGCCGGGCTTGTA-1	Invasive	IDC_2
TATTTAGTCTAGATCG-1	Invasive	IDC_5
TATTTATACCGAGTAG-1	Surrounding tumor	Tumor_edge_1
TATTTGATTTGCACAG-1	Surrounding tumor	Tumor_edge_5
TATTTGTTACCCTTTA-1	Surrounding tumor	Tumor_edge_6
TCAAACAACCGCGTCG-1	Invasive	IDC_7
TCAAACTTAGATTGTT-1	Invasive	IDC_6
TCAAAGTCACGGCGTC-1	Invasive	IDC_4
TCAAATTGTTGTGCCG-1	Invasive	IDC_2
TCAAATTTGAGACTCA-1	Tumor	DCIS/LCIS_4
TCAACAAAGATAATTC-1	Surrounding tumor	Tumor_edge_2
TCAACACATTGGGTAA-1	Invasive	IDC_5
TCAACATAGCGCCCTA-1	Invasive	IDC_4
TCAACATCGACCGAGA-1	Surrounding tumor	Tumor_edge_2
TCAACCATGTTCGGGC-1	Surrounding tumor	Tumor_edge_6
TCAACGAGGAGACAAA-1	Tumor	DCIS/LCIS_3
TCAACGCAGGAAATAA-1	Surrounding tumor	Tumor_edge_2
TCAACGCGACCGGCAG-1	Tumor	DCIS/LCIS_3
TCAACTAACGTATAAC-1	Tumor	DCIS/LCIS_3
TCAACTGCAGAGTCAG-1	Tumor	DCIS/LCIS_2
TCAAGAAATACTAGCT-1	Tumor	DCIS/LCIS_1
TCAAGCGCGGACGGTA-1	Tumor	DCIS/LCIS_2
TCAAGGTTACTACACC-1	Surrounding tumor	Tumor_edge_3
TCAATACGCCGTCATG-1	Tumor	DCIS/LCIS_4
TCAATATACAGGAGGC-1	Invasive	IDC_2
TCAATCCGGGAAGTTT-1	Invasive	IDC_2
TCACAAACCGAGGTAC-1	Invasive	IDC_2
TCACAGATCCTCAAAC-1	Invasive	IDC_5
TCACAGGTTATTGGGC-1	Tumor	DCIS/LCIS_3
TCACATCTTATCTGAT-1	Surrounding tumor	Tumor_edge_2
TCACCCTCTTAAGATT-1	Tumor	DCIS/LCIS_3
TCACCGCTCGGCACTC-1	Healthy	Healthy_1
TCACGATGTCCGTGGA-1	Surrounding tumor	Tumor_edge_2
TCACGCATTGTAGATC-1	Tumor	DCIS/LCIS_3
TCACGGCCCAAGAGAG-1	Invasive	IDC_4
TCACGGTCATCGCACA-1	Invasive	IDC_5
TCACGTGCCCGATTCA-1	Invasive	IDC_6
TCACTACGACCAATGC-1	Healthy	Healthy_1
TCACTATCCCTTCGGT-1	Invasive	IDC_2
TCACTCGTGCAACGGC-1	Healthy	Healthy_1
TCAGAACCTCCACAGG-1	Surrounding tumor	Tumor_edge_3
TCAGAACGGCGGTAAT-1	Surrounding tumor	Tumor_edge_6
TCAGAGGACGCGTTAG-1	Surrounding tumor	Tumor_edge_6
TCAGCAAATGCATCTC-1	Invasive	IDC_7
TCAGCAGTAGGCCCTG-1	Invasive	IDC_4
TCAGCCAATCCGTAAA-1	Invasive	IDC_2
TCAGCGCACGCCGTTT-1	Invasive	IDC_4
TCAGGGCGCAAACTCG-1	Surrounding tumor	Tumor_edge_6
TCAGGGTGCACGAAAC-1	Surrounding tumor	Tumor_edge_1
TCAGGGTGTAACGTAA-1	Invasive	IDC_7
TCAGGTTCTTTGAGAA-1	Tumor	DCIS/LCIS_3
TCAGTACTGACCCGCG-1	Surrounding tumor	Tumor_edge_2
TCAGTAGGGACTATAA-1	Tumor	DCIS/LCIS_3
TCAGTGTATACGTCAT-1	Invasive	IDC_4
TCAGTTACGGAATGAT-1	Tumor	DCIS/LCIS_5
TCATACTTACAGATCC-1	Invasive	IDC_5
TCATATGAGCTTTGTT-1	Tumor	DCIS/LCIS_4
TCATCACTCGAGCTCG-1	Invasive	IDC_5
TCATCCCAGAGGGTGG-1	Surrounding tumor	Tumor_edge_1
TCATCCTCAGCTGCTT-1	Invasive	IDC_2
TCATCGATGGTCCCAA-1	Invasive	IDC_4
TCATGCAGGTTCTCAT-1	Surrounding tumor	Tumor_edge_1
TCATTCGTATAATTTG-1	Healthy	Healthy_1
TCATTTAAGTCTCCGA-1	Surrounding tumor	Tumor_edge_3
TCATTTAGAAGTGTGA-1	Surrounding tumor	Tumor_edge_4
TCCAACTCAGCTATCT-1	Invasive	IDC_2
TCCAACTTTAAATTCT-1	Tumor	DCIS/LCIS_3
TCCAAGCCTAGACACA-1	Invasive	IDC_2
TCCAATAAAGGCTACC-1	Invasive	IDC_4
TCCACAATGGTTTACG-1	Tumor	DCIS/LCIS_3
TCCACATCGTATATTG-1	Invasive	IDC_2
TCCACCAAGACATAGG-1	Invasive	IDC_2
TCCACCTCTAGCCTTT-1	Surrounding tumor	Tumor_edge_6
TCCACTTTATCTAGGT-1	Invasive	IDC_7
TCCAGAGCACCGGTTC-1	Invasive	IDC_6
TCCAGATGTACGCCAA-1	Healthy	Healthy_1
TCCAGCGCTATAAGCG-1	Surrounding tumor	Tumor_edge_6
TCCAGGCAGGACGATC-1	Invasive	IDC_4
TCCAGGCGAGTACGGT-1	Invasive	IDC_6
TCCAGGGTATATACGA-1	Tumor	DCIS/LCIS_4
TCCATCAATACTAATC-1	Invasive	IDC_4
TCCATTAGTTGGATAG-1	Invasive	IDC_5
TCCATTGTGACCTCGT-1	Tumor	DCIS/LCIS_5
TCCCAAACAGACAACG-1	Healthy	Healthy_1
TCCCAAAGACGAAGGA-1	Invasive	IDC_7
TCCCAAAGCCCTAAAT-1	Tumor	DCIS/LCIS_1
TCCCACTCTCTTCCGG-1	Surrounding tumor	Tumor_edge_3
TCCCAGCTTTAGTCTG-1	Tumor	DCIS/LCIS_3
TCCCAGGCTTAGCTAA-1	Tumor	DCIS/LCIS_3
TCCCGCCTATGTGCGT-1	Surrounding tumor	Tumor_edge_3
TCCCGCGTACTCCTGG-1	Invasive	IDC_7
TCCCGGGTGTGCTGCT-1	Tumor	DCIS/LCIS_3
TCCCGGTCAGGAATTT-1	Invasive	IDC_5
TCCCGTCAGTCCCGCA-1	Invasive	IDC_7
TCCCGTCGCGTCATAG-1	Surrounding tumor	Tumor_edge_3
TCCCTAGATCAATAGG-1	Surrounding tumor	Tumor_edge_3
TCCCTCTTCTCAAGGG-1	Surrounding tumor	Tumor_edge_4
TCCCTGGCGTATTAAC-1	Invasive	IDC_4
TCCCTGGCTCGCTGGA-1	Tumor	DCIS/LCIS_3
TCCCTTAGATTACTCG-1	Surrounding tumor	Tumor_edge_1
TCCCTTGTCTGAAACT-1	Invasive	IDC_2
TCCGAACTTGGCTTAC-1	Surrounding tumor	Tumor_edge_6
TCCGAAGTAGTCACCA-1	Healthy	Healthy_1
TCCGAATGGTCCTGAG-1	Surrounding tumor	Tumor_edge_3
TCCGACCGCTAATCAA-1	Invasive	IDC_4
TCCGAGAAGGCTAAGC-1	Surrounding tumor	Tumor_edge_1
TCCGATAATTGCCATA-1	Invasive	IDC_5
TCCGATGACTGAGCTC-1	Surrounding tumor	Tumor_edge_1
TCCGATGGTGCGACAT-1	Invasive	IDC_5
TCCGATTACATTGCCG-1	Tumor	DCIS/LCIS_3
TCCGCCTGTCTACAAG-1	Tumor	DCIS/LCIS_4
TCCGCGGCAGCATCTG-1	Invasive	IDC_6
TCCGCGGCCCAATGAA-1	Invasive	IDC_2
TCCGCTGTCATCCCGG-1	Surrounding tumor	Tumor_edge_6
TCCGGAGGAAGGGCTG-1	Healthy	Healthy_1
TCCGGCCTAGCGTACA-1	Healthy	Healthy_1
TCCGGCCTGCATCGAT-1	Surrounding tumor	Tumor_edge_1
TCCGGGCTTGACGGGA-1	Invasive	IDC_2
TCCGTAACCACAATCC-1	Invasive	IDC_5
TCCGTTAAGCTAATAT-1	Invasive	IDC_2
TCCGTTTAGCCTTGAA-1	Invasive	IDC_7
TCCTAAAGATTCAGAC-1	Invasive	IDC_2
TCCTAAATTGGGAAGC-1	Tumor	DCIS/LCIS_4
TCCTAACCGTCGGGCA-1	Invasive	IDC_4
TCCTAGCAAAGAAGCT-1	Tumor	DCIS/LCIS_3
TCCTATCATAGGTAAC-1	Surrounding tumor	Tumor_edge_3
TCCTCCTAAGACATTC-1	Surrounding tumor	Tumor_edge_2
TCCTCGGGCTGGGCTT-1	Invasive	IDC_6
TCCTCTACGAGATGGC-1	Surrounding tumor	Tumor_edge_2
TCCTCTCCAGTTGTCC-1	Tumor	DCIS/LCIS_3
TCCTCTGGCCCATTAG-1	Surrounding tumor	Tumor_edge_1
TCCTGCCAACTGGAGA-1	Surrounding tumor	Tumor_edge_1
TCCTGCGTTGATACTC-1	Tumor	DCIS/LCIS_3
TCCTGGCGCTGCCTGG-1	Healthy	Healthy_1
TCCTTACGACGGTCCG-1	Surrounding tumor	Tumor_edge_5
TCCTTCAGTGGTCGAA-1	Surrounding tumor	Tumor_edge_1
TCCTTGTCCTTTAATT-1	Invasive	IDC_2
TCCTTTAAATCCGCTT-1	Invasive	IDC_2
TCCTTTCTTACGCTTA-1	Invasive	IDC_6
TCGAAATTTAGGACCA-1	Invasive	IDC_6
TCGAAGAACCGAGCAC-1	Tumor	DCIS/LCIS_1
TCGAATATCCCGCAGG-1	Invasive	IDC_4
TCGACAACTGAACCCG-1	Invasive	IDC_4
TCGACTGACGATGGCT-1	Invasive	IDC_2
TCGAGACCAACACCGT-1	Tumor	DCIS/LCIS_3
TCGAGCCAGGCAGGCC-1	Invasive	IDC_4
TCGAGGGCAACAGACG-1	Surrounding tumor	Tumor_edge_4
TCGATAGGCTAGTCGC-1	Invasive	IDC_5
TCGCACCAGGAGGCAG-1	Surrounding tumor	Tumor_edge_5
TCGCATAAAGGGCGCA-1	Surrounding tumor	Tumor_edge_4
TCGCATCCCTAAGTGT-1	Invasive	IDC_5
TCGCATTCAATGACTT-1	Invasive	IDC_5
TCGCCCAACTGACTCC-1	Healthy	Healthy_1
TCGCCGAAGTTGCGTC-1	Tumor	DCIS/LCIS_3
TCGCCGACATATTCGC-1	Invasive	IDC_2
TCGCCGGTCGATCCGT-1	Invasive	IDC_5
TCGCCTCCTTCGGCTC-1	Surrounding tumor	Tumor_edge_6
TCGCGCGTTTACATGA-1	Surrounding tumor	Tumor_edge_6
TCGCGTAGCAGTGTCC-1	Invasive	IDC_2
TCGCGTCCAGAAGGTC-1	Tumor	DCIS/LCIS_3
TCGCTAAACCGCTATC-1	Surrounding tumor	Tumor_edge_1
TCGCTACTGGCTTTGA-1	Invasive	IDC_2
TCGCTCGATATATTCC-1	Surrounding tumor	Tumor_edge_6
TCGCTCGGCACCAGCG-1	Healthy	Healthy_1
TCGCTGCCAATGCTGT-1	Invasive	IDC_2
TCGCTGGGCGGATTGT-1	Invasive	IDC_7
TCGCTGTGCGTAAATC-1	Invasive	IDC_5
TCGCTTAATTACGAAG-1	Healthy	Healthy_1
TCGCTTTAAACGTTTG-1	Surrounding tumor	Tumor_edge_6
TCGGAATGACCATCAA-1	Tumor	DCIS/LCIS_5
TCGGAATGCGCTCTGA-1	Tumor	DCIS/LCIS_3
TCGGACGCCCAGCCCA-1	Invasive	IDC_6
TCGGAGAGTATCGGGA-1	Surrounding tumor	Tumor_edge_2
TCGGAGTACATGAGTA-1	Invasive	IDC_7
TCGGCGAACCCAAACC-1	Surrounding tumor	Tumor_edge_3
TCGGCGTACTGCACAA-1	Invasive	IDC_3
TCGGCTAACTTCCCTT-1	Tumor	DCIS/LCIS_5
TCGGCTTGTATCGACG-1	Invasive	IDC_2
TCGGGAACGTGCCTAG-1	Surrounding tumor	Tumor_edge_3
TCGGGAGACAGCGTAC-1	Tumor	DCIS/LCIS_4
TCGGGATTCAAACATA-1	Surrounding tumor	Tumor_edge_2
TCGGGCCGTCGTGGTA-1	Invasive	IDC_1
TCGGGTGAAACTGCTA-1	Invasive	IDC_5
TCGGTCCCGACAATAG-1	Invasive	IDC_4
TCGGTCCCTGACTCCA-1	Surrounding tumor	Tumor_edge_1
TCGGTGACCGCTCCGG-1	Healthy	Healthy_1
TCGGTTAGCCATGTAG-1	Healthy	Healthy_1
TCGTAAGACGACATTG-1	Invasive	IDC_7
TCGTAAGCTCCGAGGA-1	Healthy	Healthy_1
TCGTACCGACGTCAAG-1	Invasive	IDC_4
TCGTATAGTGCAATTA-1	Invasive	IDC_5
TCGTATTACCCATTGC-1	Tumor	DCIS/LCIS_3
TCGTATTTCGTCCGGA-1	Tumor	DCIS/LCIS_5
TCGTCAAGTACGCGCA-1	Invasive	IDC_4
TCGTCACACTGTTAGC-1	Surrounding tumor	Tumor_edge_2
TCGTCCGCTGGCGTCT-1	Invasive	IDC_5
TCGTCCGGGTACACTC-1	Healthy	Healthy_1
TCGTCTTAGGCGTTAA-1	Invasive	IDC_2
TCGTGTATTGGTCACG-1	Surrounding tumor	Tumor_edge_5
TCGTGTCACGCTGACA-1	Surrounding tumor	Tumor_edge_2
TCGTGTTCGACCACAA-1	Tumor	DCIS/LCIS_2
TCGTTCGTTATTATGT-1	Surrounding tumor	Tumor_edge_1
TCGTTGGCTCGTCAAT-1	Invasive	IDC_5
TCGTTTACGCGACCCT-1	Invasive	IDC_2
TCTAAAGAACAGTCTC-1	Invasive	IDC_3
TCTAACCTAGCCTGCG-1	Invasive	IDC_2
TCTAATACTGCCTCAG-1	Invasive	IDC_4
TCTACACGTTCATGCA-1	Healthy	Healthy_1
TCTACCCAATAGAGAG-1	Tumor	DCIS/LCIS_2
TCTACCCGCATCATTT-1	Invasive	IDC_2
TCTACCGTCCACAAGC-1	Invasive	IDC_7
TCTACGGGCTCAGTTG-1	Healthy	Healthy_1
TCTAGCAATCTCCGCC-1	Tumor	DCIS/LCIS_3
TCTAGCATCTTCGATG-1	Invasive	IDC_5
TCTAGCATGCCCAGAA-1	Healthy	Healthy_2
TCTAGGTGGCGACGCT-1	Healthy	Healthy_1
TCTAGTGATATCGTGG-1	Tumor	DCIS/LCIS_1
TCTAGTTATCAGAAGA-1	Tumor	DCIS/LCIS_3
TCTATAGGTGGGTAAT-1	Invasive	IDC_2
TCTATCATGCAGTTAC-1	Invasive	IDC_5
TCTATCCGATTGCACA-1	Surrounding tumor	Tumor_edge_6
TCTATCGGTCGCAACA-1	Invasive	IDC_7
TCTATGCTATAACGAC-1	Invasive	IDC_2
TCTATTACGCTGGCGA-1	Invasive	IDC_5
TCTATTACTAGAGGAT-1	Surrounding tumor	Tumor_edge_2
TCTCAAATCAATCGGG-1	Invasive	IDC_2
TCTCAGGCTACTCGCT-1	Invasive	IDC_2
TCTCATGAGATAGGGT-1	Surrounding tumor	Tumor_edge_5
TCTCCAACGTAGGTTA-1	Surrounding tumor	Tumor_edge_1
TCTCCACAAGTTGAAT-1	Invasive	IDC_2
TCTCCCTGGGCAGCGT-1	Tumor	DCIS/LCIS_4
TCTCGAACGAGGTCAC-1	Healthy	Healthy_1
TCTCGACGTATCGCCG-1	Surrounding tumor	Tumor_edge_3
TCTCGAGGAGGTTCGC-1	Surrounding tumor	Tumor_edge_5
TCTCGGCTCCAGGACT-1	Invasive	IDC_5
TCTCTAATAGCTGGTA-1	Invasive	IDC_5
TCTCTCGCCGCACATA-1	Surrounding tumor	Tumor_edge_4
TCTCTTACCGCGAACC-1	Invasive	IDC_4
TCTGAACCGGTCGGCT-1	Invasive	IDC_5
TCTGAACTCGTACCCG-1	Surrounding tumor	Tumor_edge_3
TCTGAAGCACGTGGTC-1	Tumor	DCIS/LCIS_4
TCTGAATTCCGTACAA-1	Healthy	Healthy_1
TCTGACGGGCTAACCC-1	Surrounding tumor	Tumor_edge_3
TCTGACTGTAATGGTT-1	Invasive	IDC_5
TCTGAGCAATTGACTG-1	Surrounding tumor	Tumor_edge_4
TCTGATCGGGTGCTAG-1	Tumor	DCIS/LCIS_1
TCTGATGTATTCTGTC-1	Surrounding tumor	Tumor_edge_5
TCTGCATACCTTGCTT-1	Invasive	IDC_2
TCTGCCAGAAACTGCA-1	Invasive	IDC_1
TCTGCGAATCGTTCGC-1	Healthy	Healthy_1
TCTGCGTCCGGTTTCT-1	Invasive	IDC_5
TCTGGGAACCTTTGAA-1	Tumor	DCIS/LCIS_1
TCTGGGTAGCGCTCAT-1	Tumor	DCIS/LCIS_3
TCTGTCATACAAGAGC-1	Invasive	IDC_5
TCTGTGATGGAGGTTG-1	Healthy	Healthy_1
TCTGTGCCATCATAGT-1	Invasive	IDC_7
TCTGTTACCCAGCATA-1	Surrounding tumor	Tumor_edge_2
TCTTACAGAGGTACCG-1	Invasive	IDC_5
TCTTACCGGAACTCGT-1	Surrounding tumor	Tumor_edge_6
TCTTACGGCATCCGAC-1	Surrounding tumor	Tumor_edge_2
TCTTACTTATGCCTCT-1	Surrounding tumor	Tumor_edge_3
TCTTAGAGCTCCAATT-1	Tumor	DCIS/LCIS_1
TCTTAGAGTGAACTCT-1	Tumor	DCIS/LCIS_1
TCTTATGGGTAGTACC-1	Surrounding tumor	Tumor_edge_6
TCTTCCCATGGGCACA-1	Healthy	Healthy_1
TCTTCGAATAGACGTT-1	Invasive	IDC_6
TCTTCGATACCAATAA-1	Invasive	IDC_6
TCTTCGCGGTGAGAGG-1	Tumor	DCIS/LCIS_2
TCTTCTATAACCCGCC-1	Surrounding tumor	Tumor_edge_6
TCTTGATGCGTAGCGA-1	Invasive	IDC_6
TCTTGCTCCCGATACT-1	Surrounding tumor	Tumor_edge_6
TCTTGGTAACACCAAA-1	Surrounding tumor	Tumor_edge_6
TCTTTAAGACTATGAA-1	Surrounding tumor	Tumor_edge_3
TCTTTAGAGTCTAACA-1	Surrounding tumor	Tumor_edge_3
TCTTTAGCAGGCGAAC-1	Tumor	DCIS/LCIS_1
TCTTTCTCTTAAGGAG-1	Tumor	DCIS/LCIS_5
TGAAACTTATGCAAGC-1	Tumor	DCIS/LCIS_5
TGAAAGGACCTGACTC-1	Invasive	IDC_6
TGAACAAGCAGGGACT-1	Invasive	IDC_4
TGAATACCGACGCGTA-1	Invasive	IDC_2
TGAATATGCTATAAAC-1	Healthy	Healthy_1
TGAATGAGTGTTTCCC-1	Invasive	IDC_4
TGAATGTCAGCCGGCC-1	Surrounding tumor	Tumor_edge_3
TGACACTTCTCTTTGC-1	Healthy	Healthy_1
TGACATCGAGCGGACC-1	Tumor	DCIS/LCIS_1
TGACATGTAACGTGAC-1	Surrounding tumor	Tumor_edge_6
TGACCAAATCTTAAAC-1	Surrounding tumor	Tumor_edge_6
TGACCAGCTTCAAAGT-1	Healthy	Healthy_1
TGACCCACGTTAGACA-1	Tumor	DCIS/LCIS_3
TGACGAATATTTCCCT-1	Surrounding tumor	Tumor_edge_2
TGACGATGCACTAGAA-1	Surrounding tumor	Tumor_edge_6
TGACTATAATCCTTTC-1	Healthy	Healthy_2
TGACTCCGAATCATAC-1	Invasive	IDC_4
TGAGAATGCTTTACCG-1	Invasive	IDC_5
TGAGAGATTTACCACG-1	Invasive	IDC_1
TGAGATCAAATACTCA-1	Tumor	DCIS/LCIS_5
TGAGATTAGGCCCTAA-1	Healthy	Healthy_1
TGAGCAGTCGTGAAGT-1	Surrounding tumor	Tumor_edge_1
TGAGCCATACAGTCTC-1	Tumor	DCIS/LCIS_3
TGAGCGGAAAGTGTTC-1	Tumor	DCIS/LCIS_4
TGAGCTTTAATGACGC-1	Surrounding tumor	Tumor_edge_1
TGAGGAGTGCCAGCTT-1	Tumor	DCIS/LCIS_4
TGAGGTGTGTGGCGGA-1	Invasive	IDC_4
TGAGTAAATTAGCGTA-1	Healthy	Healthy_2
TGAGTGCCTCTTAAAT-1	Tumor	DCIS/LCIS_3
TGAGTGGTCCGTGACG-1	Invasive	IDC_7
TGAGTGTAACAACGGG-1	Invasive	IDC_2
TGAGTTAAAGACATTC-1	Surrounding tumor	Tumor_edge_3
TGATAGCGGGATTCTA-1	Surrounding tumor	Tumor_edge_2
TGATCACCACACTGAC-1	Invasive	IDC_4
TGATCAGGGAACTGCT-1	Surrounding tumor	Tumor_edge_6
TGATCCCAGCATTAGT-1	Surrounding tumor	Tumor_edge_3
TGATCGGTTTGACCCT-1	Invasive	IDC_6
TGATCTACGCTGATCT-1	Healthy	Healthy_1
TGATCTATCACACTCT-1	Invasive	IDC_2
TGATCTCCGGCGCCAG-1	Invasive	IDC_6
TGATGGCTGTTTCTGA-1	Surrounding tumor	Tumor_edge_3
TGATGTCAATTAAGTG-1	Surrounding tumor	Tumor_edge_4
TGATTATGGCACGCAG-1	Healthy	Healthy_1
TGATTCCCGGTTACCT-1	Invasive	IDC_4
TGATTCGTCTATCACT-1	Tumor	DCIS/LCIS_3
TGATTCTGTCGCCGGT-1	Tumor	DCIS/LCIS_3
TGATTTATTAGCTGTG-1	Tumor	DCIS/LCIS_3
TGATTTCCTCCTGACG-1	Invasive	IDC_5
TGCAAAGTTCGTCTGT-1	Invasive	IDC_4
TGCAACCCATCTGCGG-1	Invasive	IDC_2
TGCAACTACTGGTTGA-1	Invasive	IDC_2
TGCAAGAATGACGTAA-1	Invasive	IDC_6
TGCAATCTAACACGGT-1	Invasive	IDC_2
TGCAATTTGGGCACGG-1	Healthy	Healthy_1
TGCACAGTGAAGTTAT-1	Healthy	Healthy_1
TGCACGAGTCGGCAGC-1	Tumor	DCIS/LCIS_5
TGCAGAACTATATCGT-1	Surrounding tumor	Tumor_edge_2
TGCAGAGTACCGAGCA-1	Tumor	DCIS/LCIS_3
TGCAGATCGTCCTAGG-1	Surrounding tumor	Tumor_edge_2
TGCAGCTACGTACTTC-1	Surrounding tumor	Tumor_edge_2
TGCAGGATCGGCAAAG-1	Invasive	IDC_7
TGCAGTGAGGCTCGGG-1	Healthy	Healthy_1
TGCAGTGGTAGGGAAC-1	Invasive	IDC_4
TGCAGTTTCCTCCCAT-1	Invasive	IDC_1
TGCATATGTCTGTCAC-1	Healthy	Healthy_1
TGCATGGATCGGATCT-1	Invasive	IDC_7
TGCATGTGACCCATAG-1	Invasive	IDC_4
TGCATGTGGTAATCTA-1	Invasive	IDC_7
TGCCAAAGTCAGACTT-1	Surrounding tumor	Tumor_edge_2
TGCCACCTGGCGAAAC-1	Surrounding tumor	Tumor_edge_1
TGCCAGTACGTGGAGA-1	Healthy	Healthy_2
TGCCATTACTAAAGAA-1	Surrounding tumor	Tumor_edge_1
TGCCCGATAGTTAGAA-1	Invasive	IDC_2
TGCCGAAAGCGTATTC-1	Tumor	DCIS/LCIS_1
TGCCGGATGTACGAGC-1	Invasive	IDC_4
TGCCGTGGATCGTCCT-1	Tumor	DCIS/LCIS_4
TGCCGTGGGACCCAAT-1	Surrounding tumor	Tumor_edge_6
TGCCTAATTGAAGATT-1	Surrounding tumor	Tumor_edge_6
TGCCTGACATCGGTCA-1	Invasive	IDC_5
TGCCTGATCAAACGAT-1	Invasive	IDC_7
TGCCTTGGCCAGGCAA-1	Surrounding tumor	Tumor_edge_5
TGCGAATATGGGATTT-1	Surrounding tumor	Tumor_edge_2
TGCGACACCCTAGTGC-1	Tumor	DCIS/LCIS_3
TGCGACGGCCGAACGT-1	Invasive	IDC_4
TGCGAGAATATTACCC-1	Surrounding tumor	Tumor_edge_2
TGCGAGATGGCGGCCA-1	Healthy	Healthy_1
TGCGAGCCCTTCCGCG-1	Healthy	Healthy_1
TGCGCAAAGCATTTGG-1	Invasive	IDC_6
TGCGCGATTAACGGAG-1	Invasive	IDC_6
TGCGGACTTGACTCCG-1	Invasive	IDC_2
TGCGGAGTAAAGGTGC-1	Invasive	IDC_7
TGCGGCATAGTTCAAC-1	Invasive	IDC_5
TGCGGGTATTGGGATC-1	Tumor	DCIS/LCIS_5
TGCGGTGAAATTTCAT-1	Surrounding tumor	Tumor_edge_1
TGCGTAAGAACCTGAT-1	Tumor	DCIS/LCIS_3
TGCGTACGGCTAATTG-1	Invasive	IDC_2
TGCGTCATGACTGAGC-1	Invasive	IDC_3
TGCGTGATTGGGTGTC-1	Invasive	IDC_5
TGCGTTTGTTGACACT-1	Invasive	IDC_1
TGCTAAGTGTCTATTT-1	Invasive	IDC_2
TGCTATACAAACGGAC-1	Tumor	DCIS/LCIS_5
TGCTATGGCAAAGGGA-1	Invasive	IDC_4
TGCTCCACAGTTCTTA-1	Surrounding tumor	Tumor_edge_3
TGCTCGGCGAAACCCA-1	Tumor	DCIS/LCIS_4
TGCTCGGTGGGTCACC-1	Invasive	IDC_2
TGCTCTTGAGAGTTTG-1	Surrounding tumor	Tumor_edge_6
TGCTGGTTGGACAATT-1	Invasive	IDC_5
TGCTGTTGAAGAACTC-1	Invasive	IDC_6
TGCTTAGAGAGAATGC-1	Invasive	IDC_4
TGCTTCCCAAGCAGTA-1	Tumor	DCIS/LCIS_4
TGCTTGAAACCATGCA-1	Invasive	IDC_5
TGGAAACGGAGTGAAC-1	Invasive	IDC_5
TGGAACCACTGACACA-1	Healthy	Healthy_1
TGGAAGAAGGGAACGT-1	Tumor	DCIS/LCIS_3
TGGAAGACGAACACCA-1	Invasive	IDC_5
TGGAAGGATAAAGATG-1	Invasive	IDC_7
TGGAATATCCTTGACC-1	Healthy	Healthy_1
TGGAATTAGACGCTTT-1	Surrounding tumor	Tumor_edge_2
TGGACCAATCTAAGAT-1	Tumor	DCIS/LCIS_4
TGGACCACGGCGTTGA-1	Invasive	IDC_5
TGGACGCAATCCAGCC-1	Invasive	IDC_4
TGGACTGTTCGCTCAA-1	Invasive	IDC_6
TGGAGAATAATCGTCC-1	Invasive	IDC_4
TGGAGCTAAAGTTCCC-1	Tumor	DCIS/LCIS_5
TGGAGGGAAACACCTC-1	Healthy	Healthy_1
TGGAGTGATGCGATGA-1	Tumor	DCIS/LCIS_3
TGGATAGAGTAACAGA-1	Invasive	IDC_5
TGGCAAACTAAATTAC-1	Healthy	Healthy_2
TGGCAACTCGCGCGCC-1	Surrounding tumor	Tumor_edge_1
TGGCAAGCACAAGTCG-1	Invasive	IDC_4
TGGCAATGGGACGGCG-1	Surrounding tumor	Tumor_edge_4
TGGCACGAGCTCGAGT-1	Healthy	Healthy_1
TGGCAGATTACGATCA-1	Tumor	DCIS/LCIS_3
TGGCAGCAGTAATAGT-1	Tumor	DCIS/LCIS_3
TGGCATGAAGTTTGGG-1	Invasive	IDC_4
TGGCCAAACTGAAGTA-1	Invasive	IDC_7
TGGCCAATTTGGTACT-1	Invasive	IDC_3
TGGCCGTATATTGACC-1	Invasive	IDC_6
TGGCGGTGTGCGATTG-1	Invasive	IDC_5
TGGCTACACTCTACCT-1	Invasive	IDC_2
TGGCTATGTGACATAC-1	Tumor	DCIS/LCIS_4
TGGCTCTTGTCGCGTA-1	Surrounding tumor	Tumor_edge_2
TGGCTTGTACAAGCTT-1	Healthy	Healthy_1
TGGCTTTGGGTAGACA-1	Invasive	IDC_5
TGGGAAATGCCTTTCC-1	Invasive	IDC_5
TGGGATGCACTCATTC-1	Healthy	Healthy_1
TGGGCAATAGTTGGGT-1	Surrounding tumor	Tumor_edge_3
TGGGCACAAACAGAAC-1	Invasive	IDC_5
TGGGCACGTTCTATGG-1	Surrounding tumor	Tumor_edge_1
TGGGCAGGCCACCGCA-1	Surrounding tumor	Tumor_edge_5
TGGGCCACAAGAGCGC-1	Invasive	IDC_7
TGGGCCCATACTAATT-1	Surrounding tumor	Tumor_edge_5
TGGGCGATACAATAAG-1	Surrounding tumor	Tumor_edge_6
TGGGTAAGGTTCCCGC-1	Surrounding tumor	Tumor_edge_1
TGGGTGCACAAGCCAT-1	Invasive	IDC_2
TGGGTGGGATGTCATT-1	Healthy	Healthy_1
TGGGTGTAATAGATTT-1	Invasive	IDC_2
TGGGTGTTAAGTAGAA-1	Surrounding tumor	Tumor_edge_6
TGGGTTTCGGGCGTAC-1	Invasive	IDC_4
TGGTAAGCAGGATTGA-1	Surrounding tumor	Tumor_edge_2
TGGTAGAATATATGGG-1	Surrounding tumor	Tumor_edge_3
TGGTATCGCATCCCAA-1	Tumor	DCIS/LCIS_5
TGGTATCGGTCTGTAT-1	Tumor	DCIS/LCIS_5
TGGTCCCACGCTACGG-1	Tumor	DCIS/LCIS_4
TGGTCTGTTGGGCGTA-1	Tumor	DCIS/LCIS_3
TGGTGATCGTATTTGT-1	Surrounding tumor	Tumor_edge_2
TGGTGCCCTGCCTTAC-1	Invasive	IDC_4
TGGTTAAGGGCGCTGG-1	Healthy	Healthy_1
TGGTTCAACGGGTAAT-1	Healthy	Healthy_2
TGGTTCGTAGCAAAGG-1	Invasive	IDC_5
TGGTTGGAGGATCCTG-1	Surrounding tumor	Tumor_edge_1
TGGTTTAAACGTGGGT-1	Healthy	Healthy_1
TGTACCCGACCCTAAT-1	Invasive	IDC_4
TGTACCTACACGAGGG-1	Invasive	IDC_2
TGTACGAACAAATCCG-1	Tumor	DCIS/LCIS_3
TGTACTACTCTCACGG-1	Healthy	Healthy_1
TGTACTTCCGGGCATG-1	Invasive	IDC_2
TGTAGCCAATTCCGTT-1	Invasive	IDC_2
TGTAGCCATCCCATTC-1	Surrounding tumor	Tumor_edge_4
TGTAGGAGAAATTTCC-1	Healthy	Healthy_1
TGTAGTGATCTATAAT-1	Tumor	DCIS/LCIS_3
TGTATAACAGATCCTG-1	Invasive	IDC_7
TGTATCAGACTGAAGC-1	Healthy	Healthy_1
TGTATCCTTATTCCAT-1	Invasive	IDC_5
TGTATGGCGCAGACAG-1	Surrounding tumor	Tumor_edge_3
TGTATTTACCTAATGC-1	Healthy	Healthy_1
TGTCATTTGTTGGGAA-1	Healthy	Healthy_1
TGTCCACGGCTCAACT-1	Invasive	IDC_2
TGTCCCGACATAGCAC-1	Invasive	IDC_5
TGTCCGCAAACAATTC-1	Invasive	IDC_4
TGTCCGTGGCGCCTTT-1	Surrounding tumor	Tumor_edge_2
TGTCCTAAGTCACCGC-1	Tumor	DCIS/LCIS_3
TGTCGGCATGGTGGAA-1	Invasive	IDC_5
TGTCGTGGGTATAGGC-1	Invasive	IDC_4
TGTCGTTATCACATAT-1	Invasive	IDC_4
TGTCTACAGTTTCTGT-1	Invasive	IDC_5
TGTGACTACGCCAGTC-1	Invasive	IDC_7
TGTGACTAGAGTTTGC-1	Invasive	IDC_2
TGTGAGACTAGCCCAA-1	Tumor	DCIS/LCIS_4
TGTGCCGGTGCCGGAA-1	Invasive	IDC_2
TGTGCTTTACGTAAGA-1	Surrounding tumor	Tumor_edge_2
TGTGGAGGAAGCTTAA-1	Tumor	DCIS/LCIS_5
TGTGGCAAAGCGTATG-1	Invasive	IDC_7
TGTGGCGGGCTTCTGG-1	Tumor	DCIS/LCIS_4
TGTGGCTCCCACCAAC-1	Surrounding tumor	Tumor_edge_3
TGTGGTTGCTAAAGCT-1	Invasive	IDC_4
TGTGTAGTAGCACGTG-1	Tumor	DCIS/LCIS_2
TGTGTCGCGAGTTGCA-1	Invasive	IDC_5
TGTGTTCGTATCCAAG-1	Tumor	DCIS/LCIS_3
TGTTATTGTATGTGGC-1	Invasive	IDC_1
TGTTCCGCTTCCATGA-1	Tumor	DCIS/LCIS_3
TGTTCCGGCCTGAGCT-1	Invasive	IDC_2
TGTTCTCTACTCCCTA-1	Healthy	Healthy_1
TGTTCTTCCATTGACT-1	Tumor	DCIS/LCIS_3
TGTTGTCAAGAAGTCT-1	Surrounding tumor	Tumor_edge_1
TGTTTAATACTTCATC-1	Tumor	DCIS/LCIS_5
TGTTTCGGTACTTCTC-1	Invasive	IDC_5
TGTTTGAGATCGTCAG-1	Surrounding tumor	Tumor_edge_3
TTAAACAGAGTCCCGC-1	Invasive	IDC_5
TTAAACCGGTAGCGAC-1	Invasive	IDC_5
TTAAACCTGGTTCCTT-1	Surrounding tumor	Tumor_edge_2
TTAAACTCGAATTCAT-1	Healthy	Healthy_1
TTAAAGGCGATGCTCG-1	Invasive	IDC_4
TTAAAGTAAGTCGCCA-1	Invasive	IDC_2
TTAACACCTCGAACAT-1	Surrounding tumor	Tumor_edge_2
TTAACCAACCCTCCCT-1	Invasive	IDC_5
TTAACGAACAAGCAGT-1	Healthy	Healthy_1
TTAACGTCGCAAGACC-1	Invasive	IDC_5
TTAACTCACGCGTGGA-1	Surrounding tumor	Tumor_edge_2
TTAACTTCAGGTAGGA-1	Surrounding tumor	Tumor_edge_2
TTAAGACGAACGAACC-1	Healthy	Healthy_1
TTAAGATAGGATTGAC-1	Tumor	DCIS/LCIS_1
TTAAGCCGACAACTTC-1	Surrounding tumor	Tumor_edge_1
TTAAGCGCCTGACCCA-1	Tumor	DCIS/LCIS_3
TTAAGGATACGGAGGT-1	Invasive	IDC_5
TTAAGGCCCGTACTTT-1	Invasive	IDC_4
TTAAGTATTGTTATCC-1	Invasive	IDC_2
TTAATCAGTACGTCAG-1	Surrounding tumor	Tumor_edge_1
TTAATGCGAGGTAACT-1	Tumor	DCIS/LCIS_5
TTAATGTAGACCAGGT-1	Invasive	IDC_7
TTAATTGCTTTGGGTG-1	Tumor	DCIS/LCIS_4
TTAATTTCAGACGCGG-1	Surrounding tumor	Tumor_edge_6
TTACAACTACGCATCC-1	Invasive	IDC_5
TTACACGATCTGCGAC-1	Surrounding tumor	Tumor_edge_4
TTACAGACCTAAATGA-1	Healthy	Healthy_1
TTACATCGTGGCCTGG-1	Invasive	IDC_5
TTACATGCCACAACTA-1	Tumor	DCIS/LCIS_1
TTACCATTGATTACCC-1	Tumor	DCIS/LCIS_3
TTACCCATTGCCGGGT-1	Surrounding tumor	Tumor_edge_1
TTACCCTAACAGTCCT-1	Surrounding tumor	Tumor_edge_2
TTACCCTAGGGATTGG-1	Tumor	DCIS/LCIS_4
TTACCGCCTTAGGGAA-1	Invasive	IDC_5
TTACGGATGGTTCGAG-1	Healthy	Healthy_1
TTACGGTGTCACCGAG-1	Surrounding tumor	Tumor_edge_6
TTACGTATCTATGACA-1	Surrounding tumor	Tumor_edge_4
TTACTAAAGGACTTTA-1	Healthy	Healthy_2
TTACTCCGGCCGGGAA-1	Invasive	IDC_6
TTACTCTGGTACGTAC-1	Tumor	DCIS/LCIS_3
TTACTGGGATATTTCA-1	Tumor	DCIS/LCIS_3
TTACTGTCTAGAGCTC-1	Healthy	Healthy_1
TTACTGTTTCTCTACG-1	Tumor	DCIS/LCIS_5
TTAGAAGAACATGACT-1	Healthy	Healthy_2
TTAGAATAAGGGTCGG-1	Invasive	IDC_4
TTAGACACGATCGTTG-1	Surrounding tumor	Tumor_edge_1
TTAGACGAGTCACCTC-1	Healthy	Healthy_2
TTAGAGTTTAGAAGGA-1	Surrounding tumor	Tumor_edge_5
TTAGATAGGTCGATAC-1	Invasive	IDC_5
TTAGCAACATGGATGT-1	Invasive	IDC_5
TTAGCTAATACGATCT-1	Healthy	Healthy_1
TTAGCTGATTTGCCGT-1	Invasive	IDC_1
TTAGGTCATAACCGAC-1	Invasive	IDC_4
TTAGTAAACCTGCTCT-1	Invasive	IDC_2
TTAGTAGGGCGGCGGG-1	Tumor	DCIS/LCIS_3
TTAGTTATTCGTGGCA-1	Surrounding tumor	Tumor_edge_5
TTAGTTCAAGTGTTCG-1	Healthy	Healthy_1
TTATAGATGCACATTA-1	Surrounding tumor	Tumor_edge_1
TTATAGGTAATTGTCT-1	Tumor	DCIS/LCIS_4
TTATAGTCCAAGGTGC-1	Healthy	Healthy_1
TTATATACGCTGTCAC-1	Invasive	IDC_6
TTATATTTGGCAATCC-1	Invasive	IDC_7
TTATCCAATCGAACTC-1	Invasive	IDC_5
TTATCCGGGATCTATA-1	Invasive	IDC_2
TTATCCTCAAGGAATA-1	Invasive	IDC_3
TTATCGCCTGCGAAGC-1	Surrounding tumor	Tumor_edge_2
TTATCTGTATCATAAC-1	Invasive	IDC_5
TTATGAATGAAAGGGA-1	Invasive	IDC_6
TTATGACAAACTGGAT-1	Surrounding tumor	Tumor_edge_2
TTATGATCTTAACGAA-1	Surrounding tumor	Tumor_edge_6
TTATGCGTCCCGGTCC-1	Invasive	IDC_5
TTATGTTTGCGATAGA-1	Surrounding tumor	Tumor_edge_2
TTATTAGGGAAGCATC-1	Invasive	IDC_5
TTCAAAGTCTCTAGCC-1	Invasive	IDC_6
TTCAACGACCCGACCG-1	Invasive	IDC_5
TTCAAGCCGAGCTGAG-1	Surrounding tumor	Tumor_edge_1
TTCAATTAGCCATAAT-1	Tumor	DCIS/LCIS_5
TTCACGAAAGGATCAC-1	Tumor	DCIS/LCIS_3
TTCACTCGAGCACCTA-1	Tumor	DCIS/LCIS_4
TTCACTTCCTAGAACG-1	Invasive	IDC_4
TTCAGAGTAACCTGAC-1	Invasive	IDC_5
TTCAGCCCTGGTCCAC-1	Surrounding tumor	Tumor_edge_5
TTCAGCTGGCGTGCCC-1	Invasive	IDC_2
TTCAGGCGTCAAAGCC-1	Surrounding tumor	Tumor_edge_2
TTCAGTTCAAGAGGAG-1	Invasive	IDC_4
TTCATAGCCTTGTAAC-1	Invasive	IDC_5
TTCATGGCGCAACAGG-1	Surrounding tumor	Tumor_edge_1
TTCCAATCAGAGCTAG-1	Healthy	Healthy_1
TTCCAATCTGGCTATC-1	Tumor	DCIS/LCIS_3
TTCCAGACGAGATTTA-1	Tumor	DCIS/LCIS_1
TTCCATCATGCGGTGA-1	Healthy	Healthy_1
TTCCATCGACAGCGTG-1	Surrounding tumor	Tumor_edge_4
TTCCCGGCGCCAATAG-1	Invasive	IDC_3
TTCCGCAGAGAAATAT-1	Healthy	Healthy_1
TTCCGCGTGAGGCGAT-1	Healthy	Healthy_2
TTCCGGCTCGACTTCT-1	Healthy	Healthy_1
TTCCGGTATCTGTGTC-1	Tumor	DCIS/LCIS_1
TTCCGGTTACCCACTT-1	Invasive	IDC_1
TTCCTCGAGGGTGTCT-1	Invasive	IDC_5
TTCCTCGGACTAACCA-1	Surrounding tumor	Tumor_edge_5
TTCCTTTCTGTGTTGC-1	Invasive	IDC_5
TTCGACAGAGCCCGTG-1	Healthy	Healthy_2
TTCGACGGGAAGGGCG-1	Invasive	IDC_6
TTCGAGCCGGCGCTAC-1	Healthy	Healthy_1
TTCGCACTCGCGTGCT-1	Invasive	IDC_6
TTCGCACTGTACGACA-1	Tumor	DCIS/LCIS_4
TTCGCATCCGGAAGCA-1	Invasive	IDC_5
TTCGCGCGCCATACGA-1	Invasive	IDC_4
TTCGCTAGGAAGTTGT-1	Surrounding tumor	Tumor_edge_3
TTCGCTATCTGACGTG-1	Healthy	Healthy_1
TTCGGACTGATGCCTT-1	Healthy	Healthy_1
TTCGGCAACCCGCTGA-1	Surrounding tumor	Tumor_edge_1
TTCGGCTAGAGATGGT-1	Invasive	IDC_5
TTCGGGACTAATCGCG-1	Invasive	IDC_6
TTCGGGTTGCCACGGG-1	Tumor	DCIS/LCIS_2
TTCGGTACTGTAGAGG-1	Surrounding tumor	Tumor_edge_6
TTCGTAATCCCAGCGG-1	Surrounding tumor	Tumor_edge_1
TTCGTACTCCAGAACG-1	Tumor	DCIS/LCIS_3
TTCGTTCAACGAAGTT-1	Healthy	Healthy_1
TTCTAACCGAAGCTTA-1	Healthy	Healthy_1
TTCTACCTCAATCGGT-1	Invasive	IDC_4
TTCTACCTTTATGTTG-1	Surrounding tumor	Tumor_edge_1
TTCTACTTGCGAGGGC-1	Invasive	IDC_5
TTCTAGAAAGTCTTAT-1	Invasive	IDC_4
TTCTAGGCCAATTGTG-1	Invasive	IDC_5
TTCTATGCCTTTCGCA-1	Surrounding tumor	Tumor_edge_3
TTCTATTAAACGCAGC-1	Invasive	IDC_4
TTCTCAATTGCTACAA-1	Invasive	IDC_4
TTCTGACCGGGCTCAA-1	Invasive	IDC_2
TTCTGCCGCGCCTAGA-1	Healthy	Healthy_2
TTCTGCGGGTTAGCGG-1	Invasive	IDC_1
TTCTGCTAGACTCCAA-1	Surrounding tumor	Tumor_edge_3
TTCTTAGTGAACGGTG-1	Invasive	IDC_5
TTCTTAGTGGCTCAGA-1	Invasive	IDC_5
TTCTTATCCGCTGGGT-1	Surrounding tumor	Tumor_edge_6
TTCTTCCCTTTGATAT-1	Tumor	DCIS/LCIS_5
TTCTTGAGCCGCGCTA-1	Tumor	DCIS/LCIS_3
TTCTTGCTAGCATCTC-1	Tumor	DCIS/LCIS_1
TTCTTGGACGATCTGC-1	Surrounding tumor	Tumor_edge_2
TTCTTGGAGTAATGAG-1	Surrounding tumor	Tumor_edge_1
TTCTTGTAACCTAATG-1	Invasive	IDC_5
TTCTTTGGTCGCGACG-1	Healthy	Healthy_1
TTGAAAGGTGTAAAGG-1	Healthy	Healthy_1
TTGAACGAATCCTTTG-1	Invasive	IDC_5
TTGAACGACGTGCTGA-1	Invasive	IDC_2
TTGAAGAATTCCCAGG-1	Tumor	DCIS/LCIS_3
TTGAAGGATGGGCGCC-1	Invasive	IDC_4
TTGAATATGGACTTTC-1	Invasive	IDC_6
TTGAATCGTTGTATAA-1	Invasive	IDC_3
TTGAATTCACGTGAGG-1	Tumor	DCIS/LCIS_1
TTGACAGGAGCTCCCG-1	Surrounding tumor	Tumor_edge_3
TTGACATGAACGTGGA-1	Tumor	DCIS/LCIS_3
TTGACCAGGAACAACT-1	Invasive	IDC_2
TTGACCATGTTCTCCG-1	Surrounding tumor	Tumor_edge_1
TTGACCGTGTTAATGA-1	Surrounding tumor	Tumor_edge_2
TTGACGATTCAGCACG-1	Invasive	IDC_5
TTGACGCTCCATGAGC-1	Tumor	DCIS/LCIS_1
TTGACTACCATATGGT-1	Tumor	DCIS/LCIS_3
TTGACTATTGTCCGGC-1	Surrounding tumor	Tumor_edge_3
TTGAGAAGTTTAGCAT-1	Invasive	IDC_2
TTGAGAGTACTGCTAA-1	Tumor	DCIS/LCIS_3
TTGAGCAGCCCACGGT-1	Surrounding tumor	Tumor_edge_3
TTGAGCGCCACGTGAT-1	Tumor	DCIS/LCIS_1
TTGAGGCATTTAACTC-1	Healthy	Healthy_1
TTGAGTCCCGCTGCTG-1	Tumor	DCIS/LCIS_1
TTGATAGTCAATACAT-1	Surrounding tumor	Tumor_edge_3
TTGATCTAACTTTGTC-1	Invasive	IDC_6
TTGATGCCGCTCGTCG-1	Invasive	IDC_4
TTGATGTGTAGTCCCG-1	Healthy	Healthy_1
TTGATTAGCTGTTTCT-1	Tumor	DCIS/LCIS_3
TTGATTATGCAGATGA-1	Surrounding tumor	Tumor_edge_2
TTGCAAGAAGACTCCT-1	Invasive	IDC_2
TTGCACAATTCAGAAA-1	Tumor	DCIS/LCIS_3
TTGCACGGAGCAGCAC-1	Invasive	IDC_5
TTGCATGCTGATCACG-1	Tumor	DCIS/LCIS_3
TTGCCAAGCAGAACCC-1	Surrounding tumor	Tumor_edge_3
TTGCCATAGCCCGCTC-1	Surrounding tumor	Tumor_edge_2
TTGCCCTGATCACGGG-1	Tumor	DCIS/LCIS_3
TTGCCGCAGACCTACA-1	Invasive	IDC_4
TTGCCGCTTTCTAGTA-1	Tumor	DCIS/LCIS_4
TTGCCGGTGATCCCTC-1	Healthy	Healthy_1
TTGCCTAATCCAAAGT-1	Invasive	IDC_4
TTGCCTTCTCGCCGGG-1	Invasive	IDC_2
TTGCGCACAACCACGT-1	Surrounding tumor	Tumor_edge_6
TTGCGCTTGATCAATA-1	Invasive	IDC_2
TTGCGGCGACTCATGC-1	Tumor	DCIS/LCIS_5
TTGCGTAGTTTGAGGA-1	Surrounding tumor	Tumor_edge_2
TTGCGTGAACGCTTAG-1	Healthy	Healthy_1
TTGCGTGTGTAGGCAT-1	Invasive	IDC_2
TTGCTCATAGTACGTG-1	Invasive	IDC_2
TTGCTCCCATACCGGA-1	Invasive	IDC_7
TTGCTGAAGGAACCAC-1	Invasive	IDC_5
TTGCTGATCATGTTCG-1	Surrounding tumor	Tumor_edge_6
TTGCTGCACCTATCCA-1	Surrounding tumor	Tumor_edge_6
TTGCTGGCCGGGCTTC-1	Tumor	DCIS/LCIS_5
TTGGAAGAATACAGTC-1	Surrounding tumor	Tumor_edge_6
TTGGACATGTGGCTTA-1	Tumor	DCIS/LCIS_3
TTGGACCATCTGGCAA-1	Surrounding tumor	Tumor_edge_5
TTGGACCTATAACAGT-1	Invasive	IDC_2
TTGGAGTCTCCCTTCT-1	Invasive	IDC_5
TTGGATATCGTCTACG-1	Tumor	DCIS/LCIS_3
TTGGATCGACTTCTGG-1	Surrounding tumor	Tumor_edge_1
TTGGATTGGGTACCAC-1	Invasive	IDC_5
TTGGCCAAATTGTATC-1	Invasive	IDC_4
TTGGCCATCTTGCGCT-1	Invasive	IDC_5
TTGGCCTAGAATTTCG-1	Surrounding tumor	Tumor_edge_1
TTGGCGATCCGAATAT-1	Tumor	DCIS/LCIS_1
TTGGCTCAATATGTGT-1	Surrounding tumor	Tumor_edge_4
TTGGCTCGCATGAGAC-1	Invasive	IDC_5
TTGGGAAGACGAGCCG-1	Surrounding tumor	Tumor_edge_6
TTGGGACACTGCCCGC-1	Invasive	IDC_7
TTGGGACGTAAGAGTT-1	Surrounding tumor	Tumor_edge_5
TTGGGCGGCGGTTGCC-1	Invasive	IDC_7
TTGGTATGGCTTGTGT-1	Tumor	DCIS/LCIS_1
TTGGTCACACTCGTAA-1	Tumor	DCIS/LCIS_3
TTGGTTGCGGTGCGCG-1	Surrounding tumor	Tumor_edge_2
TTGTAAGGACCTAAGT-1	Tumor	DCIS/LCIS_3
TTGTAAGGCCAGTTGG-1	Invasive	IDC_7
TTGTAATCCGTACTCG-1	Tumor	DCIS/LCIS_3
TTGTATCACACAGAAT-1	Surrounding tumor	Tumor_edge_1
TTGTCGTTCAGTTACC-1	Invasive	IDC_5
TTGTGAACCTAATCCG-1	Invasive	IDC_2
TTGTGAGGCATGACGC-1	Surrounding tumor	Tumor_edge_2
TTGTGATCTGTTCAGT-1	Invasive	IDC_2
TTGTGCAGCCACGTCA-1	Tumor	DCIS/LCIS_4
TTGTGGCCCTGACAGT-1	Invasive	IDC_5
TTGTGGTAGGAGGGAT-1	Surrounding tumor	Tumor_edge_2
TTGTGGTGGTACTAAG-1	Invasive	IDC_2
TTGTGTATGCCACCAA-1	Tumor	DCIS/LCIS_4
TTGTTAGCAAATTCGA-1	Invasive	IDC_5
TTGTTCAGTGTGCTAC-1	Invasive	IDC_7
TTGTTGTGTGTCAAGA-1	Invasive	IDC_7
TTGTTTCACATCCAGG-1	Invasive	IDC_4
TTGTTTCATTAGTCTA-1	Invasive	IDC_4
TTGTTTCCATACAACT-1	Surrounding tumor	Tumor_edge_2
TTGTTTGTGTAAATTC-1	Surrounding tumor	Tumor_edge_1
